dsa24	_eSSSSSEEeFSsFSsFssSSEEeSSSSSeFFssssSSFssfSSSee_SsSSFSsseeSFssssFSsSfSsseeeE_eFfsssssfssSSSSSEeeSsSSSeeeeSFSsSSSeee_SSSFsssFSsE_SSFSsSFsseeeSFsssFfsssssSFssee_SFssSFfssssFFfseFSsssss_SfFsSSSSeSSSSe_EEee_SFfsfssssseeFSsSFSFsSFffsssffsSee_SSFsfsSFssFSseE_eeeeeeeEeeeeeeeEeEeSeeeeeeeEeeeEEeeeEFSSFeSeeEESeEee_FssSFssSSSSSSSSSSFssFSFffSSSSFs_
saa128	_EEEEeeSSSSSFSFSFSFSSSSSSSSSFSSSSSSSFSF_FsFSSSSFFS_eF_EEeFSFeeSFsFsFFe_
jhb32	_FsssssssssFSSFSfFfs_FSssSssssssssssSssseFsfsF_EEe_EEFSsSFSSssFFSsssSEeF_eSsSSFsFsSsFsSSFsSsSFFffsFFFfssF_eeeFFsfssFfsFsFsSsSFffseee_EeeFFsfsSSSsFSsSsFsfSeeeeeeFSssSSSssSsfFSsfSFssseeeeFFssSSSSSFSfFSfSFFSSsSeeeSfsFSFSFFSsfFSSsFFfssFsseFFfSsfSfsSSsSfSSFFsfFff_eSSsFeeeeeefFFSFFfFSfFffSsfsfFSFssFFfsfFFeeFfsssFssFFFSsFFFfssFfffffSFSf_EeeeeFssFfSssFfFsFFFSFSsssFFSFSsSsEeSsfSfFFfSFfFfFeeFsFFSSfEESSFFFSFFFEEeFfsfFFFSsF_
snb39	_FfSSSSS_SsssssSsfFsssssfsssFSsssSssssFssssSssseee_eee_FfSssFfsSssSssfffffeFfFfSssSsFssssFFfSsssSssFfsseeffssSSssfSssseeSsssSsSsFssssFFssSsssFSsssssFfSsssssssFs_FSsff_FfssSssssSssssSssssssSsssFsssfssssssssFFsssFsse_FfsssSSsSFFfFfSsFeFsssssssSSssFF_SssssssssssSSfFfssssFffssssFffssss_SSSsSS_eeeeeeeeEeeEeeeeSssssssssSfssSssFsssSssssFSSFFfeSssSSFfSFSFFFfSSSFSSsssFSSfF_eeeeFffFfSssFfssSfFffffSfssFfffssss_eeeSSSsSSSSFfFfSsSSFSssSssFSssFsFsssFFFffsSsssFSS_SsfsSSSfssss_eeeeSSFfSSSsssssSSsSsssSssffsssFFfSssSssFfSfsssseeSsssssssSffssffeFSsssssSssssssSsssssSfffsfssssffSssssssssFSssssseeee_Ssssss_eF_SsSsSSSsSssFffFfFsfSsSffSFfssSffSsFffSsFfFFfssFf_E_ee_eeesssssSSeEeFsSsSsSSsssfeSssssssssffsssssSssEESffssssSffssssFfssssSsssssSsssssEeSssssssssSssEeEeSsssssssSssffsssssssssSssEEeFSssssSSsSsssSSeeeeeeESsssssssSffssssfsssEeeSsssssSssssss_ESssSsssssffssSFsFsssFeSssSssSSsFeeeFFFfFsFFssssSsFFSfsssfsssssSssfsssssssseeFfsssssSsssffsssfssFssfffsfsssSssfsssFssFssssSsssee_FffSSFSssssSSsssssSfsssFsFSssseeSsssssssFFFffSfffSssssssssffsssssss_SssfssfssSsssssssssfsssssssssSsssffffssffssssFsssssFssSsssFssffsffssssfSs_
nrg14	_eeEe_SsSSFSFseeeFsFssFsFsSE_SFfsSSFsFfsFsSFFsSFsFFfSSFsSSFsFsFsFfFSFs_FssFsSSSfsFFfsSsSSSsSsFfsSFSFSFffsFffsFfffseFseFsSFfssFffFffsffFsFsSFSFfseeSfsFffs_FseeeFfssFFFfFsFfffffFfFsFsSSsEeFsSFfffFSFffsSssFfffsSESFfsfsF_
pmp27	_eeeSssssSsssfSsssFeFFsssssssFSSsssFssSssSssSsssssssssss_EeeFfFSssssFFFfF_eeeFsssssssssSFSsssssSfFsf_eSFsSSsSssFssseeFfssfSsFsssSsssssssssSssseeSFssSssSssFssssfsFFsssesfsss_Eeeeeee_FsssssssSssssSssssssssseeeeFfeeFFSssffsseSssFfssfssssssSsfsfsSssFSssSsSssFSsseeeeeeeeFsssfsssssfssseeSsFsss_eFesssFFssssFFFffFSfF_FFFeFSsfSFsssffFfsseSsssFSssssFssfsFfssssFSFFSFFssfffsseSssSsSSsFSsFffFFeeeSssSfSffeFffFeeeeFsssFeeFSssFFfsssFSssSseeeFssseFfffsssFFfFFsfsssFssseFfFsffss_eSsSsSeSsseeeeFs_eeFFFSsFSffsfffeeeee_
rdp23	_eeeSsSFSseeeeFsSSSSeeSSSFFfSFss_eFsSsFSS_S_SsSsssSFsSf_eeSSssFFseeeeFssssssFssssSssFssfs_SSsSSFSsSSfSFFSSSFeeeeeeeeeeeeee_eSSsSfseSSSFfsFsSsffFseFSSSSFfs_SFffsFseeeeeeeeeSSsfsSSssffsssssfFsssS_Fss_eeFfsffs_SFseeFsSFsSsssFFfsESfFFFfsFsFeeFsFsFFseeFffffsFfSFffsFsfFSFsFsFfsFffsFfffFsfSfSeeee_FsfsSFSSFsFSSFFSSSFfssssFFssSFFSSSsFffSFsfSSFFSsSSSFfSSFsFssFFsSeeee_
mjm248	_SSSFFFsSSeeeeeFFsssFsSFSS_SeeFFSsfSFSS_FFFFFsFsSefFFFSfFs_SFFfFSFsSSFfFsFsSfSSSFfsSFssFFfFFSSFffsFsFFsSSFsFsSFSeeeFsfsffffsFss_FFSFSfsFFfsSFfsFsfFsFsffffffsfsfsfsfffsFssFssffsfsfssffffssffffsFffffff_eeeeeeeeeee_FffsfffFsffffsFsssFsee_FffssffffssffsfFfSFfsSsFFfssfssSfFSSssffffsffffsfFfffssffssffsfsfffffffFffffSSSfffs_
ams396	_SSSSsSSFeeeFfsssFsssSSsfsFssfFeesfsSsSFsSsSSFfffFssFsSFFSsSEeFFffFFSFsssSFFfs_FSFSsfFssssSSSFFsFsSSffsSSFfeFsFsFSFfSFSSSFSFfsFSFeeeFSFFFeeFsS_FsSSFFeeFSeeeeFeeeeeeeeeeeeeeeeeeeeeeeeeeeeeeeesF_
jmk195	_SssssSsSssFSssSssfssFsssSssFssssFssssFssSsssssSssSssFsss_FfffffsssssSssssSssssSssssSssssFsssssFssssssfssssSSSsfFFssfsssssffeffFffffssssssFsssssFsssssFsfSsssFFSsfSsssSsssssFfsffffFsssssssSsssSSssssSFsfsfssssFsFsssssSfssssSssssfffssssssssSsffsssfSsssssssssfssssssssssFFsssssFssssss_FsssssssFsssssFfffSssssSsssffssffffssssfsfssssSssssSssfsFFfssssssSsssff_FfsssssSssfssfssfsFSssfffffssssFFSsssfssFsssssFFfSsfssFfeeFeeeFfsfSsssssFFFSsssfsssFsfsssSssssFsssssFsssssFsfssssFFfsssssFssfssFSsfss_SssssFsssssFssssFssssFsssssFfssssfSsssFffffSssssffsssssFFSsfssssssssfssfsssFsssssFsfssssFsssssSssssssFFFfssssssFfFfSsssf_
atg23	_SSssfsssSfsssSssSsSsSs_FSFFffFff_SSSfsfssS_ee_Ee_S_FsFFf_sFsSSFsSsSf_fFS_FSS_SsFsfffFF_FSF_
jaw154	_eSSSsseeeFfsFsSSsSSSSSSSSSssSSsSSSSsfSSFFSSSSFsFssssSSSSFseeeeeeeeeeeeeeeeeee_eFssSEeFffS_
tjg49	_SsssssssssssSssssSssssssssFSSsssssssSsssssssssssSsssFsssssssssssfSssssssssffSffSssssssssssFSssssssssssFFfffSssssssFfsssf_SsssFfsssssSsssSssFsssSsssfFsssssSssssssssssSsffSssssssssSssssffFfSsSssSSsssSfs_
mac276	_SSsfSsEEEEeEFsfsSSSeSSSSSEEeSSSSSSEeFfFSSSeeEeSSSSSeFfeeeFSfSfsFfsfSFSEEEESSSSFfSSEEeeSFsSFsSESSSFFFFSESFfSFSFSFFeSFSFsSSFEEesFFEEeFF_SSFFFsSFsseeSSFsFfsFfESSSFEEFfffSfssFSFFFeeFFEeFFfeEEEe_
hwf2	_eeeSsSsSSEeefSSSFSs_e_eSFfsSsSsS_SffsSssseESSSSfFfffseeeeeeSSSsseeeFssfsfssS_eeeESSsSSseeesFffsSFsSeFsSFFsFFffsFFseSFsFffsFsffesFsSSFeEeeeeeeeeeeee_
wah7	_eeeeSSSSSSssSsFSssssss_Ee_Sss_E_
mhr19	_SsSssSssSsSssFffsssssFsssssssSsfFsssssss_EeEeeeee_SsFffssssSFssSFsSssSFsFFsSfFsFsFSSSSfFFsFsSS_SsSSSSEeeeSSfsSFSeeeFSsSsFSeFSSsSSseFsFeeFsFFSeeeFFFF_FSFFFSFs_FsSFFFFFF_SsFSFFFeeFfFs_SssFssFsSSsSSFSSSSFfSSSSFsSsSFsSFsSSSSsfsFsfsssFsSsSSsssSSsFsSSFFSSFFsSSSsSFfFssSSFsFSFffSsSFsfFFEeeeeeeEeeeeeEeeEEeeeEeeEeeEeeeeee_SsSsFf_
rwm27	_SSSFfSsFSSFSSSSSSSS_SSSSsSFsSsssSSSSSSSFSsSSsSSSFSSFSsSSfsSFsSSFSSSSSFSSSsFFSsFSSSFFsFFSFsS_SSSSSFfsSSFSfSSFsSSFFSsFffsFfsF_
mlk93	_eeeSsSSsSSeeeFSsSSFssSeSFFSSsSSSeeSSSSSSSSSFfSsSeeee_SFfsssSFSSFssFSSSSSSeEeeeeeFFfsssSFSsSsSSSSSSSSSSSSFsSFSSSSSSSFSFSFfssSSSSFSSFFSsSFsFfssSFffsssSSFFFSsssFSSsSFFSFSSSsFSFFFffsssFfSfFsFSFSFSFFSSFSfF_
kko4	_SSSFFSEeeeeeFsSSFfsseSSSSSeefSSSssSeeSsSSFseeeeFSSSfSSeeeffsFSFsFsSSeEeeSSssseeeEeeeeeee_SFfsSFsFs_e_eSSsFFSSESFSFFsSFffFFsF_FFSeSSSSFSEeSF_FeeFFSeee_FFSSFFSSSFSeeSFSFSFSFSeSSSSEeFFSFSFSf_FeeFSFSs_e_eeFFsS_SFSS_eeFFsSFFFsFffFsfFfsFSffffSee_eeee_e_
afd10	_eSsSSSsSssssssssFsFsSFssSeeeeeee_eeeEeeee_eeeeeeeeeeE_SssFfsssSsfSsFsseeeeeeeeeeeEeeee_SsssssFfSsfsssFSssSsSSsFfSSSFfFSfsfsfsFFeeeeSsFsFFFSffFeFfsSSFssssFFsseeFsSSSSFfSFFSSSSSSSFsSSSSFsSSSFFFfSFSSSFsSSSSFssSFsSSsFSFSSFSFsSFfsSSSSFfFfSS_FfssssFfssssSssssffssfEEeeSsffsssseFfssssFfssff_eEFssSsFsffsfFfssfFFESFssFsfFFFeEFSSFFeeFFFEeeFFFFFe_ee_FfffssFfFFffSsffffffffSsSFfeeSFfSsEEEEEEESsSFFfFFf_EFfssFfSsSFff_EEFFFFeEEFSEE_SssSsFsSSsSsSSSSSSfsSsssSsssfFFSFssffsssSsFsSssSSsSssSfsssssssSsssfFsFsFsSSSFSsfsFssFfssFffFFFFSSsSFFSfffsFfSsSFFffSF_SsSSFfSFffFFF_eeeE_
mjd78	_SssSsssFSsssSsseeeFsssSsSsSssseeeSsSsSsSsFssSFSfsSsSssssSsssfSssfFfSsSsSfssSseeeFsssSsSsssssfssSsseeeeFSssssSsSSssssFFSSssSsssSssssSsessFFssssSsSsSsfssssssFSssSsssSsFFFfSs_FFssSsFSFSFssSsSssfSFFSfssFssSsSfsSFfssffSSsFFssfs_SsSsFssseeeeeeeeeeeeeeeeeeFsFFssFfSSesFfffseeeeeSsSsFFssFfSeefsSfFssSsFssEeeSSSSSeeeFFsSFsSfFsSeeeeeSsFSs_
sws19	_FsSSSSEeeeSFs_e_SSSSSSFSSSSSSsSFSSFSS_SSSSSSF_SSSSSFSSsFFSFFSSSFSSSSSSSSSFSeSSeEeFFFFS_SFSFfSSSF_SFS_FFF_Ee_FFfF_f_fFfFF_
rkh9	_ee_eeFFfFeSssFssFssSSSSfsSFsSFfssFsSsssFssSfSSSFfFfsSfssfsfSsFfsFsSssssFsSSSFsSffFssfSsFssSFfsfFF_
skm37	_SSsFsfeFfsSsssfsSFsSSsSSSsSsffsSssS_SSSSSfFssFsSsSsFsSSssSSsSFFFFssSsFfSsSFSssSSSFsFFSsFFfSFSFSfSeEeeeeeeeEeeeeeeeeee_
ril13	_SSSFsSE_SSFFSSSFSSSffsFSFsSS_FFFFsSsSfsFFSFSssFsF_SSFSSFFFSFs_FsS_eSssfSSFssSSsSSsSsFSFsSsSSsSSSS_FfsFSSS_SFsSFsFsFSSFfSF_SSSSFsSSssFsFFSsFsSsFFSSFsSSSFsSFsFsFeeSFsFsS_FfFsfsSfsFsFffFsSsSSFFffse_ffFFSSFfffFsFFSSSFFsSFfSF_FsSFFFfFFSFff_FFfF_FSSFFsFFFSSSssS_FFSFSFFFFSFSFsFffFFFfFsFFfsFFFfFfFsFfFsFFFsSFsFFsFFfsFF_
skw17	_SSSfSsFsFfSFsSssFsSSSsSSsSSSsSFSFffssFFsFS_f_SsSFSFsFsSS_
kan63	_SS_EeeSFSSfSSSFSsSFsSSSsSSSSSSFsssSssSSSSsF_eeF_
sjt27	_SSSSSS_FfsFsFsSFFssSSSFfSSSSSFfsFsFSsF_S_F_FssFffSSSsFfs_F_
jrw98	_SSSSSSSF_SSFSsFssssfSssssssSsSSsSssssffssssssfsSsssssSsSsssssSsSsFsfssfSssfSsssSsFssssSsssSfFssFfFssSsssfFfSsSSSsSsssssssSsssssSssfSsssfFSfsssssSss_FFfS_SsSFssSSfssssssFsFSfsSSsSsSSSfFsfFSssSSSFsSfssssssssssSsSssSsSsSSSsFfSssFFsssSSSSSSSSSSSSFFFFFSSSSSsSSFsSsFFffsSSSFFFSFSSSSSFsSFFfssFFSFSFs_
jme42	_SSS_EeEeSSSFSsFsSFsSSSSSFSFsFsSSSSsSSSSSSSSSSFSSSFsssSFsssSsfSssSsSSSFsss_eSSsFF_eSSSSSSeSSSSFFSSSeeeSSSSSEESSFSSSESFSsSsSeESFSsFS_EEFSfSFSsSeeFFffsssSFSsSFFFSFSsfssFssSSFFssee_
teh26	_SSSSSSSSS_eeFss_SsSS_
bpc20	_SSsSsS_FFFSseFsSsSsSsSFssSS_ee_SFSsSssSSSSSSsFSSSSSSSSSsSSsSFsFSSSSssSFFssSSSSSsSsSSsSFFsF_Ssssssffss_FSsssSssSs_SfsssssSsfSsSsssSsSSsSSSSFsssssSfsfsSsssSFssssFssssFFssSSsfSsSssSSssSssSFFffSssFFFfsSfffSssSssSSSssffsssSssssSSsssSsssFSsSsssssSssssSSsssSFFsFSsFSsFsSSsSFFSF_
jdh99	_FsSsSsFFfss_sssFFSSfFFSSfSfffsssfSsFSFFssSSfsFFFSSSfSFSsFSFffsssFFssfSSfSFFFfSFFFSfSFfFFSssFFSssSSFfSFSsSSsSsSFsSFSSSFsSFSfssFfSsSFsFSF_FFfffFffffSFsssSSFfsFFsSsFfsfFSSFsSssFsFFSsfSSFffFFSFFffsSsFSFSFSFFSFf_
wli1	_SsSSSSS_SSSFfS_SsssFffsSfssSffSSsSSSSSsssssssFsSFFffSSFsFFsssFFsFsSSSssFssSsFsSSFssSSFss_SSSFF_FfFF_FsSSFFfsfffsfFfsFfs_FsSFSFsFSSssssSSSSFS_
jum48	_SSSSSSssssSSSFFSSFsFsSFfsSFSFsFSsfsSSSSFSSSFSssFFffssFfFFfSssSfFsFsSFFFSSFFeeEee_
doc23	_SsSSsSsSe_S_FsS_SSSFSSsFfSFS_SSSsSSSSFFFfFFfSSsSFssS_FSFsFSFSSFFFSSFF_
aag45	_FsSSFSeFFFFFFSSSSSFsFfsFFsSfsSsSsFsS_SsssFSFFSSSsFSsFsSSFSFSsFFSsFfSsFsSFssFSsSsSsSFSssSssSssFFSssSsFssSsssssSssSssss_FF_f_sssSssSssFFFFfsSSfFffSSSsFfFFSffFFfSSFSssSFFSsSss_sfsssfssSSSsFssSSffsSSsFFFFfFFSSsSFFFSFSFf_f_fSs_FSsFfFFFSsSsssSFsfssSFFssFSSfssFf_FsFsFSffFFfsSsFssSsFsssFssFsFfFfsFFFFFFFsSSsFSsssSFssFfsFFsSFFFSFSsffssF_
wag7	_Fe_sssfsSFSSFSSFfSSFsfsFsSssFfFfSSSfssFsFSSFSFFsSFsFFsFSFfSFSFFFsSSFSSSSSFSSSSSFsSFSfSSSFfFSFFsSFsFfsSFFFfsFFsFssSfFSSFsFfsSsfFsFFSFFSSSSFFf_
rde8	_SSSSee_S_effsSSSSs_eSF_FffsSSFfsfsFsfFsfsSSSFSsssFfsssSfsSsFsSSssfsSSSSsSsffsSSSsFsFsFsssssssssssfssssSFssSsssSssSfFSfsss_SFSS_ssssSss_
kbs29	_eEEee_eeEeSSSssSSSsSssSsSSsFSsssSSssSs_FSsssssSssSsFssssssS_SsSSsssssSssSSSS_S_SsSsSsSsSSeeeeeeeEEE_EFSSSs_EESsSfSsSSsSsSsSsEESSSSSsSfssFSs_EEEEFSsSSsSSsSSSSSEEeFSsSsSsFFFSSSSFsssSSsSEeEEFFSSSsSsSsSssFSFSsSsEEESsSssSssSFssFsssSS_ESSsFssFsFf_Eee_SSSSFffsESSFfsSSeSSSSEESFeEeEEEEE_
dkd15	_EEeSSSSSe_eSSSSFsSSFSFfSSSFfSSFFffFsS_
ecu4	_SssSssSSsFSssEEeSfssssssSs_eeEFSSFFssSSFFSssSss_e_SsFssSsFssSseeFsfssssFssssssssFSssss_eFFeFF_SssSsSsSsSsSsSssSssSSsSssfssssSssEeFSfsssSssSsSfsssseeEeFssssSssSssfsSssSsssEeeFFsssssSssFSssssFSssSsssSSSsSssSFsSSsssssssSsSsSFssssFSsSSfsSssfS_EEeE_SFSsSsSSFFSFSFSfSssSsSSsSsFFS_SssSFSSSsFSFSsSssSSssfSSSSSSSsS_SSSFFSssfS_SFsSssSSSFSFssfsSsSSSSSSSSSSFsSFfFSfSSSsSFSS_FssFssssSsFSSSfSsFsSsFSssssSss_
mjg82	_eessFe_SSsfFsssFssssSssSsSsssSfssSsFsfssFssssssssfffffSsFssSSSSFSsSsFssFfsFffsFfFfsssfSssS_FffsfFssSsSsSssSsSsSsFssSsFssSsFSsfssFssfeSssffsffsfeFfssSssFeeFssffffffssssFfFSsfssFssssSsFSssFSffsfss_fsSffSSsFssSsFsFssFsFSssSfsFfsFfsfsfffFffffffffFfffffsffssSssssfSFffsSsFSfsSsSFFsSsSFffsSSFFfFF_
tar57	_SSSSS_sSSSSFSSFSSsSSFsSSSSSSSSSsSFsFeeee_SSSFSSFFeeeFfsfffSsFSsFFS_SSSSSF_SsSSsFssSSsSSSSSFsSSssssFsssfsseeeeFSsSSSSSssFSSFsSsSsfssssSSFSSss_sFFs_
koj1	_eSSSSSe_SSSseeeeFSSsSS_
clk93	_SsSSSS_EeESsSsSsFsssSFFsssSS_Ee_eee_SssSsSsFSssssSsse_FssFSSsFfsssssFFSSsssSsSSsSsSFsssSSssFfSsSssSsSSfsssSsSfssS_SsSSsSsSFFfFFsssSsssSsssssSFFSsSfSFSfSSSSSSSFSFsssSSF_FFSsSsFSssSS_FfSFssssSsFssSsssFssS_EEEEEEeeEEEEEEEeEEEeeEEEEeEEEESSfssSsFFSsssSFSFs_SSSsSssSssSssSSSssSsSssSfSsS_FF_EEEEeEeEeEEe_FssFFSF_SsseeEeEeeSFfssSsSSsSFSFSSSsFs_SSFSsSFssFssSSFfFSsfsssSSSfSFssSsFFFSSSssSFFsSFsSSSFFFfSFFFSsSSFfSSSfsSFFSss_SsF_f_fFsSFSSsFFfFSSSFFSFS_FFsFffsSSfsfSSFFSsSSSSFssSF_fSFSF_ffsssFfFSfFsSSfFsfsFSf_eeeeEEEEeEeEE_
mjf68	_eeesssfsseeeFssfsSs_e_eeeffeFFSFFsSFFSSSeeSSFfsFSfFFseFfeFsSFsFseeFSSSSeeFsFsFFFFsFfSf_eeEEe_fSFFfFfsSFSFSFFfSFSfFffsSF_FFsSSSSSSFsSSSfsssSSSsFSsSSSFSFsfSSSFSFFFSFffFsSFFFFfsSFSFsSSsFsFFfsSFSFsFfsSFsS_
res106	_SSSfFSse_S_eSssFfsfSSSSSsSsFFfsssssssS_SSsFfsFsSfSFFSSSSS_SSSSs_FssssfSSFSFssFs_SsFSsSseeeeeeeeeeEeeEEeEEeeeeeeeeSssFfsssfSsfss_eSssSs_SsssSSsSSsssSFssssSsssseeeFffsssssssFsssffssfsssssssfFsssssfsssSssSsSsSsfSssSssSsssSsssssSss_SssssssSFSssfsssSsSsssSsssSsSsSsSsssSsSssSsFFfsSfsssssssFssseSsFffsssssssssSsSSsFfSsssSsFfSFSsFffSsFfffFfSsssssssssSsseeeeeeeeeeeeeeeeeeEeSsffssssssSsSsSssssFSFffsffsssSsssfssFssfsssssseeSssFSfSfsSssFFffssfssssss_SsssFffsssfsssSssSsseeeeeSSSsFfFsssssssSsssFssssseSsfSssSssFsssssFsssssssseefSsssfsfsssssfssfsssseFSssFssssffsssSFffsssssfsss_EeFfssssssffssssssssSfssssssSsFffssfsSfsssseeSfssssSssFSsffsssssssssssFfFssssssssssFffFfsfsssfssfsssssssssSsssseSsssss_eeeEE_
wsh5	_FSsSSfFSsFfFsssS_sSFsFFSssFfffffF_FssSSSSSS_eeSF_
jah208	_SsSSFSSFFfssSSSSSFSSSSSSFSSSSSSFFSSSFFsssFSssFFFsFSSSSSSFSFSSSSFFSFS_S_SSsSSFsfsssSs_SEEE_SsFSSSSSFFSfSsF_SFs_sSSSSFsSSFfSsFSSSSFSSSFSSSSSSsSSSSSSSSSF_SssFSS_SSSFS_SSS_FSsSSFSssFSSFfSSSssssssssssssssssssssSSssssSssSssssSFFSffFsssSsFsffffFsSsSSSFFsFFFfSssfSSFssFFsFFSFSsSsSssFFSsSSsfsSSssSSsSs_Ff_f_fF_
mad205	_SSSe_SSSSSFSFFFSSsssSSSSs_eSFSSSSFSsSSSFFsS_EeeFSSSSSEeeeeEeeeFFsSSSSeEeSSSSSSSSFSEEEeeeeeeeeeeee_SSsFSsFsSfSssSSSSSs_FSFSSSssFsFsSSSSssFFFSssFfsssFsFsSFssFSFSsSssssSSFssFSssSSsfSfSFsfss_FFssSsssSfsSSssfssssSSsFSSfSsSsssSssfssSsSssSSSsSSsSFssSsssSSsSSfsssS_SSSFsFSSSSFSFSsFFSSsFFfFFsFFSsFSSSSFFsFSSFFSSSSSssSsSSFsSSsSSSF_SsfSsFFFSssFSSSSSFSsSSsSSSSFFFsSsfFFSSssSFSSs_fFFF_fFffFsfsssFFSSsSsSssFFssSfFSffssssFFssssSFSsSss_FSssFFSsSFssSsfsFSssFSssFFFSFSFFFFssFFFs_sSfsfSsssSssssFSsFsSsssSSsSFFffFSSsFFsFSsSSsssSfsSssFfsFfSSSFFssfs_ssSss_FfsFsFfSfSsfSFsSsFsfssfsFsSsFsfssFSsFSfsFFsFSSFsfFFSFSeeeeeeeeeeeeeeeeeSsSFSF_
rhl10	_FfFS_SsfsSSSsFSSsFssSSFssFfsSseSs_S_SsssssFsssssssSssFfssssSssFsssssssssFfssssSsSssFf_SssSsfsSSSSsSsSFsSSFssSssFsFSsSSSsFSSSSSFFs_SsSSSsSFSfFSFFF_
kmm137	_SFsSSSe_FsSFfsSSs_
kdd28	_ssSSSS_SSssssFssSsSsSSFSSSFSSSsSSFsSSSSSSFFee_SSsFSSSFSSSSSSSSSFSsF_SSSSFSS_SSSSSSSSSSFFSSfSsSSSFS_FSSFSSSFSSSF_
ams404	_fsSSSSe_SSSSSeeeFsfsFsSFSSSSSfffsfFfffffeesFSSSssFFsssSFfsSFsSsFFSeeFfeffssFSsSF_S_eeeeFfSSffssFsFFsSSFfsFfsSSsFsFseFSSFSSfSSFsFffffFFsFffsffffSFfFFFFFFffffffSSFS_SsSFssFfSsSSSSSfsFsSSsSSFsSFSSFsSfsSsSSsSSfSSFSFFSSFsSFSFSFsSFFsfSFFSFSFFfsSFFsSFSFsFfsFFffSSFFSFFS_
jlc201	_SsssSsSssSsssssFfSsssSsssFfSssFfssssFfSsfFfssssFfssSsSsssSsSSsFfffSsffssFfSsFf_ff_SsssFfsssssFfSsSsSsSsSsSsSsSsSsffSsSsSsssSsssFfssSsSsssSsSsSsFfFffSffSSsssSsSsSsssSsssSsssFfssssSsssSssssssFfssssSsssSsssssSSsssssssSsssSsFSsSsssSssSsSsSsssFfssssffSsSsssssFSsSsSsSsSSssSsFfSsFfSsSFfSSsSsFsFfssssSsssSsFFfSsssFfffSsssFfssssFfFfSsSFfsSssSsSssSSsssFfssSsssSsssFfFfSsfSssssssSsFfSsssSSsSsssSsssSsssSssSsSsSsssSssffssssSsssffssssFSsssffFfSsFsSsSsSsFssFffffssFSsFfssFFSsSsSsFSsSSsFfss_ssSsssSFf_
qim8	_EEEeSSSSFsFSsfSSsSsSsssFSSSSSSSSSSSFSSSSSFSSSSFsSSssfsSSSSSSSSSFFsSSSSSSS_sssSSssSFSsSsSSSSFsSSSSFsSsSssSSFsSSsSsFFSsfSsSSsSSSSSFssssSsSSSSsSsSsSSSS_SS_FSsfFSSsFSSSFSSFfsF_FfsSSSFsSSFSsFFFFSFFSFSsSSSFSFSS_FsFFSFSSSs_FFsFfFFSFFffsFSFSSSsSSFsSFS_SSFSSFssSFSsFFsFSFsSSSSFsSsSfFSFFFFSfsffsSsSFSfFSSS_
cac189	_FsSFSSFsFsSFSSSSS_FSFSFSFfSSFFsSSFSFSFFSFSFsSFFsSSSSSfSSSS_
alh130	_SSSseee_eeeSSsSSeee_
brs112	_SS_SsssSssSsssFSssSsseeeeFSsSsSsSsssSsSsSsSsSssSsssSSSsFFsSsSSSSsssSsSsSsFSssSfsSSsssSfsFSsSssSssSSsssSSSSssssFsSSFsssSSsssssSsssSsss_SSSsSsssSFsssFsSsFsssSSSSfSSsSsSfsSssFSssSssSSsSsSsSSSsSsssFSsSSsFssSssFSsssSfFSSsFssSSssSSsssFSsSSssFsss_FfFFfFfF_
alh133	_SsS_S_eFsFSSsSFfSSsFSfsssssSSSFSfssSs_FsssssFssssSSssssSsssSsss_F_SffSsSFfsFSsssFssSssssSssfssSsSSFSssfsFfffssFsSsFFSsSsSsSF_SfFssffssSsSSSssssSsfSsSSssSs_SSSsSsSSssSsSsSsfssSsSsSs_SSsSSSF_FssSSSSfsSfsSFSSSSSSsSSSsss_FFsSSsSFFsssfsSSsssssssssFsFssSsFSsSsFFSssssssSSfSssss_SS_fsssfSsSsFSsss_fFfsSFfFFfsFSsFFssSfSFSFFSSFSS_SssFfSsSsFfFffsFFfsFF_SsSFsSFs_fFFfFFFFFFsSs_FFfffsSSFFSSSsssss_sSSssSssFffFSSSS_FSSsFssfs_fFsFFFffFFFFf_SsSfsfSFssFFsSsFfSfSsFs_FFFssFffFFFsssSfFsFsSFfFfsFFSsffffFfsFfFFFfssssfsSFsFFFSSSfFFFsFs_FSfssSsFsSSFFfFFFsS_Fs_fFsFsSSSsssff_SSFFSfSFsFFFFSFfsFFSSSsSSFFssfFFfSfSfSFsSSsFSSSFSfSFSfFsSSFFFSsfs_
anv35	_SSSSSFSSSSSeeeeeeSFsSFSFseFSSSSSsSeeFfSSSSfseeFSSSSSeeeeSFFSSSSSeee_e_eeEeFSFSSSFSSSSFFsssFSeeeSSFSSSSSFFFFFeESSFFFSFSSFSFSSSFfsFSFFFsffFFeeS_seeeFFSFSFFFFFsSS_eeeeeSSFFsFsFfFseeSFeSsfssFSeFSs_FsssFsSFsssfssFSSSSSSSSSSSSSsSSFsSSSSFFfsFssFfsFsFSsSs_SSSSSeeFFsFSSFFffFSeeFee_SSsFfSSFSSSsSSssfsSSSSfSssFfssfsSsSSSsSSFSSssfsSssSSSSSFsSSSSFFssFfsSFfsFsFsSSSSFFsFSsSFFe_
inf4	_EEEESSSSSeEEFsSeeeFsSSESsSSFsEEFfseSSSssSeeSSSssFSEEEE_FsFsSsSeeefsFSfssFFFSsfs_e_SFsSFsFsEeeEeEeSFSSFsSeeeeeFsSFFSSFFseSFsFsFfsFfsFffFF_FfFfseFfSffFFfsSFsFffffffseeSFfffsFFseeeFFffffsfffsFFffsSFseeFsFfsFffsFfsFfFseSSSFfs_eEeeeeeEeEEeeeeeee_EEFESFFF_eeeE_eee_FSFeeefsS_FfffFFffffffS_FSSSSFSFfsFSFFsssfFffFfsS_SSsfSSFsSFSSSSSSSSSFsSFssSFsSssfSFSSSSSFsSSSsFfssSsSFSSSSFSFfsSfsfFSSSFsSSSSeFseeeseeseseeeee_Ee_
jey16	_eeeeeeeeeeeee_SssssssssssssfssssssssssssssssssssFsssssssSssFSssssFSsfssssSssssssSsssSssfssSsfsssssssSsssSsssssss_eSsssssssfsssssssfssssssssssssssssssssssssssssssfsssssssssssssssssssssssssssssssssssssssssssssssssssssssssssssssSsssssssssssSsSsssssssSssssSssssSssss_SssS_eeeeeeeSssSssssssssssssfssssssssssssssss_eee_s_F_e_FsfFSSFSFSSsFFfsssFfFsss_eeeeF_FSssfsssssssssFfssssSsssFsSssssFfSssSsssSssssssFSfss_SssFSsssSssF_eeEeeeFFFFsss_eeeeeEEeeeEeFFsSF_
jdh98	_eEeSSSSSSSSSS_eeeeeFSSSsEEEeeeeFFssssSssSeF_SssssssssssssSffSssssSsssssSsSssssEEe_SsSSSseeFSsfSSsssSssEESsSsSSeEeEFSSssseeeeSsSSSssSssEEeeeeeeSsSssFfSsfFfSss_e_eeeeFSssFssssSsssFSssFSsffseeee_EEeSssSssSssFSssssFssfeFSsfsssSSSssssssFFfSSSSfsssFSssssFFSsssseSsssSssssSsssssssSffsssssssSfFSSFsSsSEFsssssSfSssfsssSssssssssSssssssSfffseeSSsssFFSFFSfSFSSfFFFFsSsss_EEEFSFSFSfsSsSSSfSFFFSfSSSsssssSssssssSssssssEeeESsSsssssssSSSFSsssSSESssSsssFSssssFSsSeeee_eeEeFsSssSssFFfSsssssSssFsss_ee_EeSfssFFFfSsfFFFsSsssfeE_
atr16	_eeSSsSSeeeeFsSSFss_eeeeeeeSFsSFsSeesFssssfseeSSsSffSeEeeFSsssSeeeeFsSSfsffss_eeee_eeeeFfsFfssSFFsEeeFsFsSFsFseSFffsFFFseSFsFsFffsFffSFFfs_e_FffsFffseFsFfsSFsSEEFsFFffsFfsEeEFFffsFFFSFfs_ffsSEEeFsFsFffsFSFFseSFfFSSFS_FsssfFssssFfFssssfFssSsssssssffsSssSSsSfSSsFfsFfFSSSFsfSFsSfsFsFseeeeSSFSSSSsSFsSFsSFFs_eeFFeeSeEFFfsFsfffsFffffseeFsFsFffffffffffffFsfsFfsfs_
pjs52	_SsSsSsFfSseeFSssSssFSssSsSssSssSSSSsSssSsS_FffsssFsfSsSssSFSsSsSssSssSssSssSfFFfSssSssSssFSsFsssFsSsSsssFffssfsssFSssFFSssSssSsFSss_EeeSsssSsssFFSsSssSssFssssSSsFFSSssFFSssSssSSfFFsSsssSssSsssSFssssFfsssSsssFssssSSFSfFsssFsssSsEee_FSssssFsSfSssFFFsSssF_
cev9	_eee_eeeFsSSseeeeeeSsSSSFs_SSSSSF_SFsSSSfsSSsFSSfseSSsFSsFFffsSfsSSFfFsfsSS_SsFfsSsSFsFS_ee_eeEeeeeeEeeeeeeee_fFsSSFFsFFS_eFSFSsFsFSFFfsF_
egm18	_eeeSSsssSSSfsSeeeSSSSSe_SsFSssssSeee_FsFsFssFsee_SFFsssSeeee_eeeFssfsfsFsSFsFfssSFSeeee_eeefsFsSFFsSessFFsFfFsFSSFsFsFfffffsFFfsfeessFsSseeFsfFfFfsFFfs_FffffssFSsFFsFSSFfffseesFfsfsse_FffsFfFfsFfsFsSeeeFffffffs_eeeeeeFs_
jhg10	_SSS_SSsSSSfssSsSSSSSSsSsSSS_SFSFSS_eeSSSFsEeeSSSFSsSSSSFsFeee_eeeeeeeeeeeeeeeeeeeeeeee_eeeeFsSsSeeeeFseeS_eee_SsfseeeeFeeessffsSSe_FsSSFsSSFfsFssSSeeeeeeeeSsSFfs_eSSSSFsFfsFfsFsfseeeeeeeFs_SsSSeeeeeeeeeee_FS_FfsFfsFSsFFFfffs_FffsFssfFffsSeeee_
jdh73	_eeeSSSFSSeeeFSSSSSeSsSffsFFSseeSSSSSSeeFFssSsFFeeeeFSSSFSSeeeFFSsSSFfssSeeeeSsSSSseeeSSSSSeeeeFssfssSFSfSFseSSSSSFSeSSFsFSeFSSSsSsseeeeeESFFeeSSFssfsSSSsFSsFFFsSsseeSssSFSFSFssSfSSSSe_eeeSSSeeSSssffSSf_
leg33	_SSSFSSeFssSsSsSSFssFFSSSFsFfSssFsssSssssSsFsssSSsSSssFSsssSsFssFssSssSSSFsSFSfssSSsSsFsFssFsFFfSSfSsFFssSSSssSSsSsFFsSFFFFSsssSssSssSssFsSssFSsSssssSFsFFSFFSFssFsssFSfFFSsFFFsSFsSSSSSSSFssFFeesssFFsfEeefeeFFsFFFsSsSsFFsfFFFssFS_
kav33	_SSSsssffssssssssssSsssSssFSsssFSssfssssFSsssssssssssSsSssSsSsssssssssssFfeSssssssssssse_EEEeeeeeFSssFfssSSssSSsSsSsSsFsseeeSsSssFfsssSsssSssSSsSsSsEEeeSsSsSSssssSsSSSEeEeFfSsssFfSssSssFSsssssSssEEE_
cap77	_SssssSSssssFFSfSsssssse_eeee_eEeeeFFSfFSSeFSFFeeeeeeeeeeeeSSSSFeeeFsSSFFSeFSSFFfeSFsSFF_SFffSSFSsF_
kmh117	_eSSSFSSEeeFSSFsSSeeeSSSSSeSFSSSSseeFSSssfseeFFssSSSSSeEEeFSSSfFSsSEEeSSSSFSeeEE_eeeSSSsFSeFssSsssfFffsSFfFfF_eSfsSfsFFeFFsFSFffffsssfsFfsfsfffssffsfs_SFffSeFSsffFfFSsfsSSFssSseeSFffffFfFffffFSssssSfsfsfFsfeeeFsFSFFFsSFSssfsEeFFssFssFfffffsFsFFfFsESSS_fSSfSfsfFSf_e_
djp60	_eeSSSFSSFSSSSSEEeEEEE_ESSSSSEe_FFSFSSSSFSEEEEEeFSSSSFsFsSSSSeEeSFFsFFFsSFSeeeeEEeESSSSSeeeeeeeeEeeE_SFSSFFsSESSSFsFFFFfffs_EFseFS_
mjf68	_eeeSSSFSSe_FssSEeEFFsFsFsESFfSSFsFseesFfsSSSFSEeSSFsSFsEEeEFsSSSSEEeFFfsfSSFFsSFffseee_EEeeFsFfsSSFFseeeFsFSSSFseFsSFFFeSFsFSF_
ryc17	_eeEesFSFSSEEeFFFsSSS_
tol16	_SsSSSS_FsFSSSS_SSSSSSSSSSSFsSSSSFSSSsSSSSSSsSSEEEEEE_SSFSSSSSSSSSSSSf_SSsss_Ff_EEEE_EEEEeEEe_EEEeEeeEeeEEEEEEEeeE_
yaz44	_SSSSSFSfSSFSFSSSfssSSSssSSsSSSSSSSSSS_SFSSffsSsSFsSFseeeeee_eeEEeeEeEEee_Eee_SSSSSSFSSsSSssFsSFsSsssFSsssSSFsSSSfsSSSSSFFfsSsSssssS_EEeEEeeEeeEeeeeeEEEEeE_SSFFfsFFfsFFssssfSSFffffFFFFFFFFsFfSFsSfffsSFs_EeeEeeefs_
bjs49	_SseeeeeeeSsssssSsSsssssssFsssfsssfssssssffssssssssSsssssssssssssssssssSsssssssSsssssss_SssFsssSssSfSSSssSSFFsssSsssSsSfsSsSsSsSFSFssSSsSssSsFssSsSfsseeeeeeeeeee_SSSFssSSeeeeeeeFFfSSSsFS_EeeSsFSsSsFSsSFSsSsFffSssSsFFfssseeFssFssFssFssfffSssSFssssfsfssFsSssffeSsFSfFSfSSseEFsFSsFSSS_FfssSssSssssSssSssSssFFsssSsfsFssSeeeFSsssFSfsssSssSfseeee_FfsssSsssssffffssssssFfssssssffssssssSfssffFfSsFfFfFfff_
fek10	_eeeeFfsSfsSee_eeeeeeeEe_FFff_
chg57	_eeeSsSssSsSsFss_eeeFSFssFssSsSfSssssssssFs_eeefsfffssfssSSsssFseesfSsssfsff_eeeeFsfsFsFsffsssseeeFFffSsfFFsSsfSssssfssss_eeeeFFssssFFfffssfssssssssfsfsse_eeeffSsSsFsSseSfsSffsfsfFssssssf_eeeee_eeeeeEEe_SssSseeEFSSFssSessSSSeeSsSSSSEesssSfEeeeFsSsSseeeSssFSSFEeeeFsSSSeeesSSFsFseSSfsFsFfsfseSsFsFssSFseFSfSFFssSeesFsfeeSfFsEeeefffffsfF_ee_eeFFeeFf_
art47	_eSffssSsSsSFsffsSSssSssSsSSsffsSSssffsFfssssFfsFsssssffssFfssSsfsSeeeee_
jky3	_eeeeeeeSsssSFsSFssFsSeSSsSFffs_eeSSSSsFsEeSSSSSfSEeEeFsSSSs_eeFffssFsFffffsFsFFse_eSe_SSsSSFSFsSFfSSFSsSFsSsSSSsSSSSFsSsSSFSSsSSFfsssSSsFffsFsFffs_ee_EEeeFsFsSSFfse_eeESFsSFsFs_eFsFsFfFe_eSfFSSF_e_FsSFsesfssFsSe_fsSFFsFSssssFsssFssFfsffFFFFSsS_eeFsFfssFeeeFeeeSSS_E_eeeESSSEeeSFsSSEFsSsssFseSfF_E_EEee_EEEEeEeEEe_
ket38	_FFFfSsFssSSSsFssFfsSSsSsSsfsSsFSsFsseFFSsFfsFssFfSF_
abr26	_EeeSSSFFsSEeEeFSSsFsSSFsSFSSFFsSSFSFFseFSfSSFFeFSFsFFFEeeeFSssssssFsssFSSSSFSsssFSSFFFFEEeeeeeEeFFFFSsFFsFSsFFSfSsSFSfSFsSSSSsSSFFSsFsFsFssSSSSSSSFsFSFSFSS_FsFfEeEe_
mjs187	_SSSFSSFSSFSSSSSSSSeeeeeeeSSssSSsSSsSSSSSeeeeeee_SFsSSSSeeeeeeeeeeeeeeSsSFSFSSSSSSFsSFsFfssssSFssssssssFFfssssSseee_EEeeFsFsSSFS_eeEeSFssSSSSFsssFSssFfFf_FfsfssssssSsssssssseeeeeeeeeeSSSSssssSSSSssssSSSSSFfFsSsSSSSsseeeeeeeeeeeeeeeee_eeee_e_
rjm105	_eSSSFSSFSSSSSSSSSFsSFsSSSSSFsSSSFSSSFSSFFsSSFsSFSs_SSSSS_FSFsFfSfFFFFFFFSFSS_
vac24	_eeeSSSSSEEEFssSFfSFsSESSSSFseeeEeSFsSsssS_eeEeeSsSsFs_eeEeEEFSsSSFSSeEEFfFsffffFSFffF_
avn10	_eSSssssSssSSSsSsSSSsFSsSssSsSssSSeeeeeeeSssSSSSSssSsseeeSssSSssSssSSssSeSss_FSSsSSssSssSSsEeSSseeeeSssSssSsSsSSseeeeeSSSFFFsfSsssssSsssSsFFFSsSsSSSeeeeS_
jam267	_FFSsFFfFfffsFsSFFsFFSfSFFFSFSFFfs_
ang92	_e_EEeESSSSSEFfSSSeeEESSEFSSSSFSEEFSSSseSSsFSEESSSSSeEeESSSSSEEeSSSFSSSeee_SFSFsSSS_eeEESSFSSeeeSFSSSeSSSSeFSSFSsSSFeesseEeSSSFeSFS_e_
kmt51	_SSSFSSeeEeFFs_eeee_eeEeeeFsSFfsssSSeSSSSFssseESSSSSFsssSSeESsSSSeEEEEeEFSsssSFfssSSFfeFsssSSFffssfssFSFsssFssSFSFFSSF_FssSSSSFssssEeEeEEE_efSffSfSSFSsSSeEeSFSSFsSEFfSsSFFsSssSsSsFsSEEFFSSf_SEEEFfssFssSSEe_SSFFffsSFFsESSSFSEEeeFsFFsSFEEFSFs_EeFsSSeeEEeeFfffsFsFSFSFFfFS_
sbb28	_SsSssSssSssSsseEeeSssSssSssSsSsseeeSssSssSsFsssSssse_FfFFFSs_fFFFSSsfssSSffSsFsSSsssSSSSSSfSSssFsssSsssssSsSsFSssfsssSSFFSfssSsfsssFSsSsSssFFSsfsFSfsssssFfsssssFFfFsfsSssssSsssFsssEeeEeeeeeee_FSsfsssssSssSsSSsssSssssfssssssSSssssEEeeeeeee_SssSsSSsssSFSSFssssEeeFSsssssSSssssFFSsFssFSssFssssssFFFFFFfeFsssFsssssFfSSFFfSSfssssFsssFffsssssssFsfFSfSsfeSssssF_FffFsffssssSsfssssFSsssssFSsfsssFffSssFfSfffssSssFeeEEEeeEe_FsfFFFF_eFF_FFSsfsssFfSsfssssFFffsSsSssssSsssSsssSSsFFf_FffsssFssfssFFfssssSFfSsssFSfsssSsssSSsSSsssFssseeFssFFSsssFSssFSssssSfSfssss_SsFf_FsssSSsSsFsssFSsfSsFsssffssfsssFsfssFeeSsssFFfSFSsFFffssFFfssFsffsssFFSFSEe_
sab155	_SSSFSS_FSFfsFSsFFfSsSsSFsFSSSFssFFFSsssfsSFSSFfssFssffsssssSfsSsSSFffsfsSsFffFfSssSffSSsFfsSsFsFSsSffSfFFFSSSSFSsSssssSsFfffFFfSsfssFsssFfSSssfFSssSsFSssseesSsSsFSSFsssSSssfsSSssFfssssfSssssssssssFsssfSfSssSsSSsSssFFsSssFsssssSsssssFFfSssFssssssssSSsFssssssSsSssffffssfSsfFFfSsSsssFSsssFfss_FFFffSSsSsssSSSFFSsSsFsssfSFsssSssfSfSssfsssssSsssssFSssSssSsssFSssfssssFsssfssFfSsssfsFsssffFfFsfFFssfSfFFsFffffffffsssSffffFFFF_
ksd19	_FFsFsSFsSFsSSFSSEEEEEEESFS_EEESSSFFSSE_
rsb45	_SSSFSSeeeeeeFsFsSFsSeSfsSSS_SFsSSSSeeSSsSFsFsFfssSSSSFSSfsSFs_eEeEeEeEeeeEe_SFsSSSEeeSFsSSSeSSSSeSFfFsSSSFFseSSSFfssSFFFseESFfFfF_fSFeEESSFfSFseeSSFfSSFseSSFsS_EEFsFFFSee_
drr38	_sssFSFSSFSFSSsFSSSsSFFSSSSSSfFFSFSFFFFSFFFSFSFSSFSSFFSSSFfFfFF_FfsFSFFsSFFFFFFFFFF_SFSSFfSFFFfSSSFFSFFS_
