dsa24	_S_Fss_s_FSS_s_Ffssss_FF_fs_FSsssss_s_ffss_S_s_S_S_S_s_s_s_Ffsfssss_s_Fss_s_F_s_fs_S_Fffsss_ffs_S_s_s_FSFS_S_Fss_FSs_s_FS_s_f_S_S_fss_S_fss_S_S_S_S_S_s_s_S_S_S_FSs_F_s_fffSs_S_s_Fs
jhb32	_SSfFSsfS_FSSS_ffss_Sss_sS_FSfFSfS_FFSsss_Sfs_FSFSFF_SSfFSSs_FFfss_Fss_fffssfsfs_Sss_sfss_FFsf_Fff_s_ss_ffffS_FFfFSfFfFSsfSfFSFssF_FfsffF_ffsss_FSS_fffss_FFFFSsF_FFFFFS_FSf_Fss_ffsss_fffsffFS_FSSSS_FfSFSs_SS_ssfs_ffff_S_ffff_F_fsffssf_Ss_FF_Fs_fFF_FFSFFFFSS_F
snb39	_sssssss_Ss_ssss_sssffsss_fffsss_Sss_Ffsfssss_Ssssssss_SffssffF_Ssssss_Sssssss_Ssssss_Sfffsfssssffsssssssss_f_ssssss_Ssssss_f_Ss_Ss_S_s_ss_S_ss_fff_Fffs_f_Ss_SffS_ffss_S_ffSs_Fffssff_f_ffss_ff_s_Ss_ss_S_s_Fsss_Ss_S_Ssss_f_ssss_sss_ssffss_sss_Sss_Sffs_sss_SffssssFfssss_Ssssss_Sss_sss_S_sss_sSs_ss_Sss_Ssss_ssss_sssffssssss_Sss_Sss_FSs_sss_sSs_Ssss_S_s_ssss_ssss_sffs_ss_sfsss_Sss_sss_Sss_ss_ss_sss_ssssss_ffsss_FsFsss_F_sss_SSs_s_S_S_F_f_FFf_Fs_FFSsss_SsFFS_fsss_fsssss_sssfsss_Sssss_ffsssss_ssssffsssfss_FSSFFFSFSsS_Sssfsss_fss_FSsSsSsSs_fffss_Fsssss_SSsSsSs_Sfsss_FsFSsss_ssssssss_ffFffS_fffssssss_Ss_sffsss_ssss_SS_sfss_fss_ssssssssss_fsssssssss_ssss_ffffssffssss_fsss_ss_Fss_Ssss_fssffsffssss_f_ss
nrg14	_S_s_Ss_S_S_ffs_s_fs_fs_fffs_Fffs_Ffffs_fs_FSS_ffs_S_FfFFffs_ff_Fs_fs_S_Fs_Ffs_S_fs_Fffs_Fs_FFSS_FfFfFs_FfffffFfFs_Fss_Ss_FsS_Fffffs_Fffs_Sss_FfffsS_S_Ffs_fs_F
pmp27	_sss_fsss_Fsss_fsssss_Fsss_Ss_Fsss_fsss_ffssss_ffffffsf_F_FFF_F_SsfSFsssf_fffss_ssss_FSSSSs_fssfs_Ffssss_FS_F_FS_FFssfffss_sss_sss_SS_FSs_FFfFF_sss_Sfsff_Ffff_FSSS_FFSss_FFfsss_Fsss_ss_fsss_Ffffsss_fffffsfsss_Fsss_FfFsffss_Ss_Ss_ss_ss_fs_FFFSs_fsffs_ff_f
rdp23	_f_fs_s_s_s_s_f_Fs_s_s_s_FS_s_ffs_ffs_s_fs_Fs_S_fs_Ssss_FFfs_S_fFFFfs_fs_F_fs_fs_F_fs_fffffs_Ffs_FFFS_Fs_fFs_FS_Fs_Ffs_Fffs_FfffFs_FS_fS_F_s_fs_s_FS_S_fs_fs_s_F_FS_S_s_ffs_s_s_s_f_Fs_s_S_f_Fs_s_s_s_Fff_s_FS_fs_S_FF_s_s_S_s_s_ff_S_S_Fs_fs_s_ffs_s
mjm248	_fs_FS_S_fs_fsfsffffs_fss_Ffs_Fs_fs_F_Ffs_S_Ffs_fsf_fs_fs_ffffffsfs_fsfsf_ffs_fss_FSS_ffsfs_Fss_FffFs_sffffs_FFFffFF_FfFSF_ffFs_ffffs_fsss_fs_fffss_ffffssffsf_FFSFFSSS_FffssfssS_FFS_Sss_ffffsf_fffsf_Ffffss_ffss_ffs_fsfff_ffffFffff_S_S_s_fffs
ams396	_fsf_S_s_ffss_s_s_S_S_S_FFs_fs_s_s_ffss_S_Ff_Fs_FS_fs_FfS_FS_s_s_FS_Ffs_F_s_f_FS_FF_FFs_S_FS_S_s_fFfs_f_s_F
jmk195	_fsssssss_fsssss_ffffsssss_Ssssffs_sffffssssf_sfssss_SSSSS_sssfs_FFfssssss_Ssss_ff_ffsssss_sssfss_FSSFSFSSS_fffffssss_FFSsSsFss_fsssss_fFfssfss_Ff_FFFSFSSSsSS_FFFSsssfsss_Fsfsss_sssss_fsssss_Fsssss_fsfssss_fffsssss_Fssfss_Fssfss_Sssss_Fsssss_fssss_fssss_fsssss_ffssss_f_ssss_ff_fffsssss_ffsssss_FFssfsss_sssss_Fssfsss_fsssss_Fsfssss_FSSSSS_Sssssss_ffffssssss_FfFFSSsSF
mac276	_S_Fs_s_S_s_S_FF_FFS_s_FfS_Fs_FS_F_F_s_fS_FS_SS_F_s_F_F_F_F_S_S_FF_fss_fss_S_S_Fs_Ffs_ff_S_S_S_F_ffffSfss_fs_f_ff_F_F_f_Ff
hwf2	_fs_s_fs_fs_s_S_s_s_s_s_S_s_s_Fffs_S_Fs_s_fs_s_ffs_FFffs_ffs_s_FS_fffs_FS_Ff_s_fs_S_s_F
mhr19	_fFf_Fs_s_S_s_Fs_s_fs_s_S_s_s_s_f_s_s_S_Sff_s_s_S_S_Fs_S_s_S_Fs_s_Fs_s_S_S_SS_fs_fs_fs_s_s_f_s_s_s_s_S_ss_s_S_S_s_fs_s_s_FF_S_S_F_fs_S_S_Ss_s_ff_f_S_s_S_s_Fs_Fs_fff_S_S_S_fs_f_ff_ssss_Ff
rwm27	_S_S_fs_s_fs_s_s_FS_S_s_S_s_FS_S_S_s_ffs_S_Fs_S_S_Ffs_FFs_FS_S_S_s_s_S_S_ffs_S_S_FS_fS_s_fs_s_s_ff_s_s_fffs_Ffs_F
mlk93	_S_S_s_S_s_Fs_S_FS_s_s_S_S_S_S_FS_FS_FFSS_S_S_S_S_FS_S_Ffss_S_Fs_FFss_S_fffsss_S_S_FffSsss_F_s_sss_F_FS_FS_s_ss_FS_FF_fffsss_ffsffs_F_S_FS_FS_Ffs_s_FS_ff
kko4	_S_s_FS_ffs_S_FFFFFsF_FFS_s_s_S_S_FS_s_F_F_FFs_FFS_S_FFS_S_S_FS_S_fS_Fs_Fs_Fs_S_S_s_s_FFS_Fs_f_s_f_F_FS_FS_s_ffs_S_S_FS_S_ffs_s_FFFS_FffFs_fffs_FS_ffffs
afd10	_F_F_f_S_S_F_F_f_F_F_F_F_F_F_F_Ffffss_ffFfffSsffffffff_Ss_S_Ff_S_ffss_Ss_S_fff_F_Ff_FfSs_FfSs_S_fff_F_F_F_F_f_S_S_S_s_S_s_fss_S_s_S_s_S_s_s_s_S_S_fs_S_s_s_s_S_s_s_s_ffF_S_Fs_s_Ffsss_Ss_FsS_sss_ss_S_s_s_Sfss_s_s_s_ss_S_ss_s_fFs_Fs_fss_s_s_FSs_fs_fss_FFSS_fff_FF_F_F_s_s_S_S_FF_S_fffs_F_fss_S_fFff_S_F_Ss_S_S_FfS_ffff_F_f
mjd78	_fsss_Ssss_SS_FFFfSs_ffss_SS_Fs_fsfss_ss_ss_SFS_FFsfss_FSs_Ss_Sfs_SffssffSss_f_fssfs_Ss_ss_fsss_Fs_F_FSs_FfS_S_s_Ffffs_Ss_ss_f_Fss_Ffs_FsSF_Fss_Ss_fss_S_S_S_S_S_ffs_s_FS_S_ffs_S_S_s_FSs
sws19	_F_S_S_S_F_S_s_S_S_S_S_S_S_S_F_S_S_S_F_F_ffs_S_f_S_F_f_S_S_S_f_S_F_S_F_F_f_FF_f_F_f_f_F_f_F_f
rkh9	_FfFfs_S_fs_s_fs_FS_s_ffs_fs_s_s_s_s_s_Fs_S_S_s_fs_s_fffs_s_f_s_s_FS_s_s_ffs_f_F_f
skm37	_S_s_Ss_fs_s_Sss_s_s_s_S_FF_F_fss_ss_Ff_S_s_s_FSss_S_S_s_FS_F_fs_sF_F_f_S_f_S_F_S_fS
ril13	_S_S_S_fs_S_S_s_S_FS_FFS_s_fs_S_s_FFs_s_fs_s_S_S_fs_s_fs_Fs_f_s_FS_fs_S_Ff_fs_FS_s_FS_Fs_FffFs_S_s_S_S_FFFfs_fFFFS_S_Ffff_Fs_FfS_S_S_FfsS_FfS_F_Fs_S_FF_FFFFS_Fff_F_Ff_F_FS_S_Ffs_FFfS_S_Sss_S_FFs_FS_FfFFS_fs_fs_ffff_f_Ff_fs_fffs_FFFFFfFS_FfFs_fFfs_S_Fs_Ffs_Fffs_fF
jrw98	_S_s_Ss_S_S_S_ffs_fFSs_s_sS_S_Fs_sfsss_s_s_s_Ss_s_s_S_s_s_s_s_S_s_s_s_S_S_s_s_ffsss_FFsss_S_s_S_s_S_S_s_s_S_S_S_s_fffff_S_S_S_S_SsSS_Fs_Ss_Ff_Ffs_S_S_S_F_FFS_FSS_S_S_s_fs_S_FFFss_fFS_FSFS
jme42	_s_s_F_F_s_S_s_S_S_S_s_s_S_S_FF_S_S_S_S_S_S_S_S_S_s_Fs_S_S_S_FSs_Ss_S_s_Fss_F_s_fs_f_S_FSs_S_ffffsss_s_FSS_S_fFfs_FSS_fss_Fss_S_s_ffss
bpc20	_Ss_sfss_sss_SsfSs_Ss_ss_Ss_S_Ss_SS_Ss_Fsssss_Sfsfs_Ssss_SFSSss_FSSss_Ffss_sssfss_sss_SSss_Sss_SFfffsss_FFffsSfffsss_SssSs_Sssffsss_Sssss_S_Ssss_Ss_ss_FSs_Ssssss_sssss_SSsss_Sffs_FSs_F_Ss_FS_s_SS_S_FFS_f
jdh99	_Fs_S_fs_s_S_FS_s_FSfSS_FfSs_SFS_FS_F_FFFfFFFFffS_Fsss_S_S_Ffs_FFs_Ss_Ffsf_FS_S_Fs_Sss_Fs_FF_Ssf_S_S_FfffFs_FFffs_Ss_fS_Fs_fsffs_F_f
wli1	_FFss_s_Ffs_Fs_S_s_S_S_S_fss_s_s_Fs_s_S_Fss_S_S_fss_S_S_S_f_F_ffff_fs_s_S_fffs_Fffs_fffs_Ffs_FsS_FS_FsFsSssss_S_SS_s_FS
aag45	_FFFFfsSS_ffffS_S_Ss_FfFFSff_FffsS_Fssss_FFSs_Sss_sfsssfss_SSSsFsS_SSffs_SSs_FFFFfF_F_SSss_FFFS_fs_Ff_f_fSs_fss_fffffSs_SSsSS_FsfssS_F_fss_FS_sfss_FF_FS_FsFSFfFFfS_Ss_fss_ss_FsSs_Fss_Fs_FfffsFfF_F_FFFS_S_Ss_FSsss_sfss_Ffs_FFs_s_F_f_FS_Fs_s_ffss_F
wag7	_s_s_S_s_FS_S_S_S_S_Fs_S_Fs_FS_S_s_fffs_FFs_S_fs_FFS_s_FFFfs_FFs_Fss_s_ffS_S_Fs_FFS_s_s_fFs_FFS_FF_S_S_S_S_Fff
rde8	_Sssfs_s_s_S_S_s_Ss_ffs_s_s_Ss_fs_fs_fss_Ss_sss_ss_S_s_FSs_ss_s_fss_Ssss_Sss_Sffsfsss_s_FS_S_sSSS_Sss
kbs29	_SSS_SS_FSs_Ss_Ss_FFFSSSS_FsssS_Ss_S_FFss_Ss_SsSs_Sss_FSFssss_Ss_Sss_SssS_Fss_Fssss_s_s_ss_fss_FS_Ff_S_s_s_S_Fffs_S_S_Ffs_S_S_s_s_S_S_s_F
ecu4	_s_s_fs_s_S_S_fs_s_S_s_F_S_s_fss_Ss_SSFFSFS_Fsfsss_SsS_Ss_Ss_F_Fs_Sss_SFS_SSs_FSFSSSSS_Ssss_fss_SS_SS_Ss_s_s_S_S_FFSs_s_fs_S_Fs_S_s_s_s_s_s_FS_Fss_fs_s_s_S_s_S_S_S_S_s_S_s_S_FS_S_fffS_fSS_Ss_S_FS_S_FSs_fsss_s_Ss_FS_S_Sfss_Fs_Ss_FSssss_Sss
mjg82	_Ss_fss_ss_fssfss_Fss_f_sss_ffsffsf_FFSS_Sss_F_FSS_ffffffssss_Ff_fss_fss_Fssss_Ss_f_Sss_Fsffsfss_fss_ffsss_FSS_Ss_FS_fss_FS_fsss_Sfs_FFs_Ffs_fsfff_Ffffff_FFfFfFfFfSFfSs_Sssss_f_sfffsss_Fsfs_Ss_S_f_Fs_ss_S_Fffs_sS_FFf_f_f
tar57	_S_S_S_s_fs_s_s_S_s_s_s_s_s_S_Fs_s_s_s_S_s_S_Fs_S_S_fss_Fs_s_s_S_s_S_s_s_s_FS_S_Fs_S_s_S_s_fsss_s_s_S_FS_Ss_s_s_ffs
clk93	_s_S_s_s_s_s_S_ss_S_fss_S_Ff_Fss_FF_s_F_Sss_S_Ffss_SsS_ss_s_Fsfss_Ss_Fs_ss_FSS_sfss_FsS_S_S_fffssfssss_s_SF_S_FSS_Ss_FFF_S_s_SSS_S_FFs_S_Fs_S_Ss_Ffffs_FFF_S_s_S_s_Ffsssfss_FFSss_Ss_f_f_f_Fs_S_FS_Ss_fffFs_S_S_FFS_F_S_fFs_Fffs_S_S_fsfs_S_Ffss_s_S_S_S_fss_S_F_fS_Fs_F_ffsss_F_ffs_f_FS_S_s_fFsfs_fs_f
mjf68	_S_ss_S_S_fs_s_s_s_fs_s_s_S_S_S_S_fs_s_s_s_S_FS_fs_FS_s_S_FS_F_ffs_ffffs_S_FFfFfs_S_F_S_Fs_S_S_s_fs_fffs_S_F_S_Fs_Ffs_s_fs_S
res106	_Ss_ss_FFsSss_sfsss_Sss_Ss_ss_Ss_fSss_Sss_Ssss_SssS_ss_ss_s_Ss_ss_sss_S_FSss_fsss_ss_ss_ss_Ss_ss_Ss_ss_Ss_Ss_ss_ss_ss_sss_FFfsSfsssssss_Fsss_ss_FFfSsSSSsSSs_ss_SSs_FFSSssSs_FfSFSsFffSsFfffFfSsssssssssSss_ssffssssss_SsSs_SSsSs_fSFffsffsssSsss_FssFssFsSssss_sss_fSfSfsSss_FFffssfssssss_SS_ss_FffsssFsss_sss_sss_SS_Ss_Fffsssssss_Ssss_Fsssss_SsfSSs_Sss_fsssss_Fssssssss_fssssfsfsssssfssfssss_fsssfssss_ffsss_sfffsssssfsss_ffssssss_ffssssssss_Sfsssss_SSs_FffssfsSfssss_sfssss_sss_FSSFFSSSsSss_SsSS_fffssssssssss_FFFFFSfsssfSsFSssssssss_Sssss_s_s_S_s_s_s
jah208	_S_s_FfSs_f_S_s_S_S_FS_s_S_FS_S_s_S_S_Ss_S_S_s_S_S_S_S_S_S_F_S_s_s_FSs_s_S_S_f_S_S_S_S_FSs_s_s_FSSSFSSFFSSSssSSsSsssSsSSssSssSs_SSSsSSSsS_SssssS_ffsfffsssss_FsffffFs_Ss_s_S_S_ffsfFFfSssfss_FSs_F_Fs_FFS_fSs_Ss_Ss_s_FFSs_S_s_s_fs_s_Sss_S_Ss_s_S_Ff_f_fF
mad205	_s_sss_s_s_S_s_s_S_s_s_FSsSss_S_s_s_s_Ss_fssss_S_S_S_Fs_Fs_S_S_S_fs_fss_FfSssf_FfFFs_F_fss_FSSS_s_FFS_FSS_ffS_ss_S_Sss_SS_S_SFss_SS_SS_S_F_Ssfss_FfFSss_FSSSS_SFSS_SSs_ss_ss_FFFS_Ssf_fFs_SSSS_fs_Ss_fFFF_fFffFsFsSs_Ff_S_Ss_Ss_Sss_FFssS_fFSffssss_FFssssS_FSsS_s_s_fsss_ffSs_SFSS_Ssfs_FSsSF_Sss_FfFSFsF_FFFssFfFs_s_SfSfSsss_Sss_Ss_FSs_fs_Ss_Ss_S_Ss_S_Fffffs_ss_FFS_FSsS_s_s_s_s_s_FS_S_s_sffs_Ffs_S_S_FFss_fs_sS_Sss_ffs_Fs_FfSfSsf_S_FS_S_s_FS_fss_fs_Fs_ssFsfss_fs_s_Fsfsf_fs_FS_s_Fs_FFFS_fS_S_s_s_fs_F
rhl10	_s_S_s_S_s_S_F_S_S_s_Fs_s_s_s_s_Fs_FSs_s_s_Ss_FS_s_s_s_S_Ffs_Ss_Ss_Ss_S_FSf_fS_F_F_F
kdd28	_s_S_S_S_S_S_S_s_S_FSs_F_S_S_S_S_FSs_SSS_SS_SS_SS_S_FFssfss_ss_S_FS_FSs_FSS_S_F_s_S_S_F
ams404	_FS_fffffffs_Fffs_FFfFS_FfFFFfFFffffffS_s_fS_s_S_S_fs_s_Ff_S_s_S_s_s_s_S_fs_fs_S_S_S_S_S_Fs_S_FS_s_Fs_S_fs_S_S_S_S_S_S_S_FS_S_fsFF_S_S_Fs_S_FS_Fs_Fs_S_FFs_fS_FFs_FS_fffs_S_FFs_S_FS_fs_ffs_FFFFS_S_Ffs_FFS
jlc201	_SsSs_FfssssffSs_ssssss_fssss_SsSsS_Sss_ssffss_FfSs_s_FfS_SsSs_Fs_ffssss_ssss_Ss_FFfSsss_FfFfSsSs_Ffssss_FfffssS_FfsSssss_SSs_SSsss_Ffss_Ssss_ssss_FfFfSsfSssssss_Ss_Ff_Ssss_SSs_Ssss_Ssss_ssss_Sss_sssssssssssffssssssss_ffssss_F_ssss_ff_ff_Ss_FsSs_Ss_Ss_fss_Fffffss_FSs_Ffss_Ffss_Ss_Ss_FSs_S_Ss_Ffss_ss_ss_ss_S_ff
qim8	_ss_s_S_S_S_S_S_s_S_s_s_S_S_S_S_S_Fss_fFS_ss_fS_S_s_fs_S_Ffs_F_FfS_S_S_S_Fss_S_FSs_Ffff_S_Ffs_fSs_S_s_S_FS_FS_S_fs_FFS_FS_S_Ss_Ffs_Ffffs_FFFFS_FS_Fs_S_SS_S_S_Fs_S_Fs_S_S_Fs_s_fss_S_FSs_FFS_Fs_fss_ss_S_Fs_Ss_SffSff_FFSfsffs_sss_FS_f_FSss
brs112	_Ss_SS_Ss_Ss_s_fsss_FsSs_FsssS_SS_s_fs_ss_ss_sfs_Sss_FSss_sss_Sss_Ss_SS_Ss_SS_Ss_Ss_FSS_s_Ss_Fss_sss_FSs_Ss_SffSS_sfss_S_Ss_s_s_ssss_fss_s_Sss_fsss_fffffff_F
alh133	_ss_Ff_Ss_S_s_fffffs_fffs_Ff_SS_SFs_S_fs_ff_F_f_F_ffffFs_Ss_FFfffs_S_S_f_FS_S_S_sssss_s_S_Sss_Sss_FffFS_s_SS_F_s_Ss_Fss_fs_ffs_F_FFFF_FF_FFf_Ss_sfs_fs_Fss_F_fs_SS_ffsf_Ss_FS_Ff_fss_Fff_FF_FSSS_S_f_fs_fs_s_Ff_Ffs_FFSsffff_Ffs_FfFF_Ffssss_fs_SFs_FFFSS_SfFF_Fs_FS_F_Sfss_SS_Fs_s_SffffFfss_fs_fFs_Fs_s_S_SsSs_ff_s_s_f_F_S_f_S_Fs_Ff_FFS_Ffs_ffs_s_s_s_s_s_f_Fs_s_fF_f_F_Sf_SFS_fss_s_s_F_s_S_s_FSF_S_F_s_f_FS_S_s_f_Ff_S_s_fs
anv35	_S_s_S_S_S_s_s_S_s_S_Fs_S_s_s_S_fffs_fs_s_Ffs_Fs_FSs_s_s_S_S_S_S_S_F_Fs_FS_S_Fffff_S_f_S_S_s_FFS_S_fs_S_S_s_s_s_s_s_fs_S_S_s_s_fS_S_s_FfS_s_Fs_S_s_S_S_s_s_S_S_fs_s_S_s_fs_s_s_s_S_s_S_S_S_Fs_s_S_s_s_FFss_Ffs_S_ffs_Fs_fs_s_S_S_S_FFs_Fss_S_ff
inf4	_S_s_ffs_FS_fFf_Fs_Ffs_s_FffffFffffffs_FS_S_S_S_fs_ffs_FS_FFSss_ffffffs_S_S_S_s_FS_s_fs_S_FS_S_s_s_s_s_s_S_S_fs_S_Fs_S_S_FS_S_S_s_fS_FS_S_s_S_S_Fs_s_s_S_s_Ffs_s_s_s_S_fS_S_S_s_FS_ffs_S_fs_ffs_S_S_FS_s_S_S_S_fs_S_s_S
jey16	_s_s_s_s_s_S_s_S_Sss_Sss_Sssss_ss_Ss_sfssss_Ss_sss_ssss_sss_s_f_Fsf_fs_S_F_S_F_S_S_s_FFfsss_Fffsss_F_FSssfsssssssss_Ffssss_Ssss_FS_Sssss_ff_Sss_ssss_SSss_sss_Fsfss_Sss_FSsss_Sss_F_F_FfFsss_Ffs_S_F
jdh98	_Sss_Sss_Sss_FSssss_Fssf_fssfsss_sssssssss_FffSsssfsss_FSSssS_FFSssss_ssss_SSSSS_ssssssss_SfFSssssss_SFFSS_FsSsS_fsssss_sfsssfsss_SSSSSSSSs_Sssssss_SFFFS_Sssss_F_FSFFSfSFSSfFFFFsssss_FSFSFSFSSs_SSsfS_FFFSfSS_Sssssssssssss_Sssssss_SsSsssssss_Sss_F_Ssss_SS_Sss_Ssss_FSssss_Fsss_Fssss_Sss_FFfSsssss_Sss_Fsss_Sfss_Ffffssf_F_ffsssss_f
atr16	_FFFfS_FFFS_Ffs_ffs_S_Fs_Fs_Fffs_FS_Ffs_S_FfFS_s_fs_Fsssf_fssss_fffssss_fFss_ss_SS_ss_ss_FFs_sss_s_SS_Sf_S_Ss_ffs_ff_F_S_s_S_fsf_S_Fs_Sfs_Fs_Fs_S_S_FS_S_s_Ss_s_Fs_S_fs_S_F_fs_FFS_F_Ffs_Fs_fffs_Fffffs_fs_Fs_FFFFFFFFFFFFF_Fs_fs_FFs_FS
pjs52	_fffssfsss_FSss_fF_Sss_SssSS_Fsss_Ssss_SSsS_FFSs_sss_sss_FSSSS_SSs_FFS_sss_FF_SSS_Sss_SSfF_Fsssss_Sss_Ssss_Sfssss_ffsss_Ssss_Fsss_SSS_FSfFsss_fsss_ss_FSssss_fssfsss_f_ffssss_F
egm18	_fs_fs_Fs_S_FFs_S_s_s_ffs_FFFs_FS_s_FS_fs_FfffffS_FFFs_f_s_s_FS_S_S_fs_fffFfs_Fffs_FFFffsS_FSs_Ffs_Fs_S_Ffffs_S_Ffs_fs_s_Fffs_FfFfs_Ffs_fs_s_fffffffs_Fs
jhg10	_Fs_s_S_s_fs_Fs_s_ffs_s_S_fs_S_s_FS_S_S_ffs_fs_S_S_S_Ss_s_ffs_s_S_S_S_fs_ffs_ffs_Fs_fs_fs_S_s_s_S_F_s_ffs_Ffs_Fs_S_FFFfffs_Fffs_FS_S_ffffs_S
jdh73	_s_fssfss_s_fsf_S_Fs_s_S_s_S_S_FS_s_s_FS_FS_fss_SS_sss_s_ff_S_S_FSsfs_Ss_Ss_FSs_ffFs_sss_Sss_S_Fs_Fsfs_s_Sf_S_S_S_S_S_SS_S_S_s_s_ff_s_sf
leg33	_FsFss_Fs_FFfSsfSs_FfssSS_Sss_sss_Ss_ffssFffFssss_Sss_Sss_Sss_Fs_Sss_fss_sssss_Sfs_FFS_FFS_fss_FSSS_fSf_FF_Ss_FFFs_sfs_Ss_SSSS_SFss_FF_sss_ffsf_FFFS_FFFsSsss_f_Fsffffss_fS
kmh117	_s_sss_FFfFsS_FfFfF_sfs_s_fs_F_F_ffs_FS_fffffss_Sfs_FfSfs_fffssffsfs_S_fffS_fss_fffffssfss_S_Fss_SS_s_fffff_FfFffffFSsss_s_S_fsfsffsf_FS_FS_FFFS_S_FSs_SFS_FFss_Fss_ffffffs_Fs_Ffffs_S_S_s_fs_s_f_S_fsf_F_s_F
yaz44	_s_Fs_S_fs_S_s_S_S_FS_s_s_S_s_S_fs_s_s_S_fs_S_s_s_s_s_fFfs_ss_ss_S_s_s_s_S_s_f_Ffs_f_Ffs_FFs_s_ss_FS_S_ffffff_f_F_F_f_F_f_fs_FFS_FS_sfffs_S_fs_fs
bjs49	_FS_Ss_FSs_Ss_FSs_s_Fss_Ss_fffsss_Ss_FFfsss_fss_FSS_fss_Fss_FfFSSS_S_fssss_fs_FSS_FsS_SsFF_ss_FSf_FSfsss_FSFSS_FSSS_FfssSss_sssss_sss_Sss_Sss_Ffsss_Ssfs_Fsss_FSSss_FSfsss_sss_Sfs_ffss_sssssss_FfFfSsSsSs_Ffssss_Ss_ffssssss_sfss_ffffSsFfFfFfff
chg57	_S_s_S_s_Fs_S_fs_S_s_s_s_s_s_S_s_s_s_S_S_S_S_s_S_S_f_Fs_S_s_S_S_S_s_s_FS_s_F_fs_S_S_S_s_s_S_Fs_fs_s_s_fs_Fs_Ffsfs_s_S_fs_FSS_Sfs_fs_fsFfss_S_s_fsfSffs_FFFFFSf_F_f_f_ff
jky3	_FS_S_s_S_S_Ffsss_s_s_s_Fffs_Fs_ff_fs_Fs_Fs_S_S_Ffs_S_Fs_S_Fs_Fs_fs_fs_Fff_s_ffsS_F_FsS_fs_s_fs_s_Fs_S_fs_s_Ffs_FSssss_fsss_FSS_ffsff_FFFF_ss_s_Fs_ffssF_F_S_S_S_s_S_s_S_fs_S_S_Fs_ssss_fs_s_F_F
abr26	_F_S_FS_s_F_FSfSs_s_Fsf_S_Fs_s_S_S_S_s_S_S_F_FSs_fs_Fs_Fss_S_s_s_s_s_s_S_fs_FS_FS_FS_s_Fs_Ff
mjs187	_Ffssss_S_Fsss_sssss_Fffssssss_fs_fs_s_S_Fs_S_Fss_S_S_S_s_fsss_fsss_FF_Ff_f_fsfsssSSs_Sssssssss_s_S_s_S_S_s_s_s_S_S_S_s_s_s_S_s_S_s_s_S_S_fffsss_s_s_S_S_s_s
ang92	_S_f_S_fs_S_S_S_s_s_f_S_S_s_F_S_S_s_S_s_s_S_f_S_s_F_s_s_S_S_F_s_s_S_S_S_F_S_F_S
kmt51	_Fssss_fSffSf_S_S_Fss_S_S_s_FS_S_Fs_s_ffss_s_FFSSSS_Ss_SS_FS_S_FFs_sf_S_Ffss_Fss_S_S_S_S_ffffs_S_Ffs_S_S_S_Fs_Fs_Ffs_s_F_Fs_Fs_Fs_S_S_ffffs_Fs_FS_FS_fff_FS
sbb28	_FsffSfSsf_Sssss_F_Fff_fsffssss_ssfssss_FSSSSSS_FSsfsss_FFF_sss_ffsfffsssss_F_Fsf_F_F_FF_FF_FFSSFSsS_FfSsfssss_FFffsSs_sssss_ssss_Ssss_Sss_fff_FfFSss_Fssfss_Fffsssss_FfSsss_Fsfsss_Ssss_SSsS_Ssss_Fsss_fss_FFSsss_Fsss_FSssss_Sf_sfssss_Ss_ff_Fsss_sss_Ss_fsss_F_Ss_FSS_fsss_FFssfSss_Fsfss_FSsss_Fffs_fss_Ffffss_FFFSS_Fsffsss_ffs_FS
sab155	_ss_f_s_s_Sss_Ffssssf_sssss_ss_s_Sss_Fsss_FSFSSsSS_s_Ss_Sss_ffs_Sss_Fsssss_Ss_ssss_FFfSsSFSsssSsSsS_SS_Fssssss_s_s_SS_S_ffffssfSsfFffSs_sss_s_FSss_s_ffss_FFfffsssssss_ss_sFFssss_FsssfSFsss_sssfSfSssfsssss_Ssssss_FSsssss_Ssss_FSssfssss_fsssfss_ffssssfs_fsss_fffffsfF_Fss_fSfF_fsfffffffffsss_S_fffff_F_F_f
rsb45	_S_S_Fs_S_S_s_s_s_s_S_s_FfFS_s_S_S_FFs_s_s_S_Ffsss_FFFS_S_ffffF_fs_F_S_S_Ff_S_fs_S_S_Ffs_S_Fs_S_S_fs_s_Fs_FF_F_s
drr38	_FFFS_F_s_FsS_FS_s_FFss_S_Fffff_F_FfS_FS_ffs_S_FFF_F_f_ff_F_F_F_S_F_S_S_F_f_S_F_F_FFS_SS_f_f_S_F_F_S
