j2D_Arrays1	_FssSFs_FSsSSsssssffSsSsss_FFFSs_fss_fFfs_fsssss_FS_ffffSfss_fFfsFsSsS_s_Ss_FFS_FFfS_Sfs_F_FfFFS_s_F_FFf_FFSssfFsfs_fssssfsfsssssfssfssss_SS_F_ffssss_S_FS_Sfss_FFS_FSssss_Fs_Fs_S_FFSs_Fs_FSsss_Fs_FFFS_
j2D_Arrays2	_s_SfffsfssssffsssssssssFffssfffssffsffssss_fsffs_fsffs_ffssss_f_fs_ffsfsffs_s_FffSssssssss_Fs_Fffff_SffssffSss_FS_FSfs_Fss_fsffs_F_Ffsssfssffsssfs_fs_fsssfssss_sssssssssssffssssssss_Fs_SffffFfss_fFfFs_Ffffssf_fssfsss_fs_s_Ffs_Fffs_FF_FF_
j2D_arrays3	_F_fff_ff_F_f_f_fffFf_ffs_Fff_ffFffffs_FF_f_f_fs_F_fFff_ffsss_Fff_Ffs_Ff_f_F_fss_F_F_f_
j2D_arrays4	_s_ssssssffssss_f_fss_ssss_ff_ffFfffssss_s_s_s_Ff_fssfs_ffsS_ffff_s_fffs_sfffsssssfsss_ssss_s_ffsssss_ffssss_s_Ffs_s_s_ff_
jArray1	_S_FFS_FFSFFFFSS_FFfFfSSSSSsSSsSS_FFSS_FSSS_FSS_FFFffFFFfFSF_FS_FFFSFSSSsSS_FSF_FS_FSS_FS_FFSS_FFS_FSsF_SS_S_F_F_FFFFS_FS_Fs_S_S_S_SS_FFFfFFFFffS_S_FS_FFFFFFS_FFSS_FFFF_FSSFFfFfFfFfSFfSs_FSSSF_FFFFSS_SS_FFSS_SSsS_S_SSs_FfS_FFFSSSSSFSSSFS_FFSSS_FFFffFSS_FSFSFSFSSs_FFFfSS_SSS_FFFffsS_S_S_FFFS_F_FSSFS_S_FFFSSSSFSFSS_FFFFFSf_F_FFFFSSS_S_S_S_S_FFFFSSFSsS_S_FFS_
jArray2	_S_F_FfssSfFffffSfssSfsSSssfss_FfFfFs_FFSss_sS_ffFs_FF_FFFSsssfsss_Ff_FS_Fs_S_S_S_FS_FFFfSs_S_FfffFff_Fs_s_S_S_S_Fsss_S_FF_ffffffssssSssss_SfS_FFsSFs_ss_SFFssssSsSss_Fs_SSsss_S_FffSssSFsSS_FSFsS_fffs_SSsfS_FFFSS_Sss_FfFfs_S_S_FS_fs_FSFSSS_F_F_s_S_Ffss_FfSsfssss_S_FFFS_
jArray3	_FSs_FfFfssssFSssFfSSSfss_FfffffFfFs_FFfsss_FfffFsFs_ffffs_Fsfsss_fFS_FF_S_S_FFS_FFf_Ss_F_FffS_S_FFS_Ss_FFFFfFffSs_Fff_FFs_FFS_FffsssFsss_FSsSs_Ffss_S_FFfsFfSf_FFFFFSSFFs_FFffs_FFFSfSS_FfsFS_SSfF_Ffs_S_FSsfs_FFFSS_S_FfssSss_S_Fss_FFffsSs_Ff_F_
jArray4	_S_Ssssssssssssssssssssss_Fss_Fsss_sfs_fsss_sssss_fss_FsS_s_S_S_FS_ss_S_Fs_S_S_Fs_Ss_fsssfffsss_SFs_SS_sss_FFssS_Ssss_S_FssSsfs_Ss_S_Sssssssssssss_ffsS_Fsssss_fs_fs_Ss_S_s_sssss_s_f_S_S_sssss_S_s_
jArray5	_fss_fSssSsssfsssssssss_Ss_ss_fs_fs_fsssss_fss_s_s_S_S_Fffss_fsss_Sf_S_S_S_FS_fffs_Sss_fssFsfs_FsF_SS_sss_ffss_Sss_ssss_FssFSss_ffssSSfs_Ss_fs_Sssssss_Ss_Sss_s_ffs_Ss_FSs_s_sss_s_F_S_ssss_fs_FsS_
jArrayList1	_S_FSFsFs_FsssssSssss_FsS_fsss_Fs_Ffffss_FFs_Fsssss_S_FSFs_S_FS_S_Ssfss_Ss_S_FFS_S_Ffs_SS_S_Ss_FS_FSsss_FssssSs_S_Ss_SS_FfFssS_Fs_S_FfFfSsfSssssss_S_FSsfss_SSFss_Fss_SsSsssssss_FsSs_Ssss_FSs_Ss_Ssss_FFssfs_s_Sss_Ff_S_S_S_Ssss_S_FS_
jArrayList2	_FsssFSS_FF_fsssSfsssssssffsssssffffssffssss_Fffs_Ffffsss_S_ffss_S_fsfssss_S_FFFs_S_S_fS_SS_ss_S_S_Fs_SsSS_s_Ffsf_Fs_sfss_SsS_Ss_Sfs_Ss_SFssssFsfss_FS_Ss_FSs_FFSS_SfffsS_ffs_Sss_Fss_Sfssss_Ffs_s_S_FFFsSsss_Fss_s_Sss_S_S_Sss_S_s_
jArrayList3	_Ffsssssss_fffffsfffsssffffsss_Fffffs_fffffsfsss_fs_ffs_fffsssss_Fs_Ffff_ffs_Ffss_Fs_ffffFff_f_f_Ffs_Fs_Fs_Fs_Ffs_ff_Ffffs_Ffsfffs_Fffsssssss_Ffs_Fs_Ff_FfffS_ffffffsf_Ffsfsff_Fffs_F_FffsFs_ffsss_Fs_ffs_FsSf_f_ffffffss_fFfs_Ffsss_fffsss_ffffs_fffFffsssss_Ffs_FFss_
jArrayList4	_S_SssFffsss_Sss_Fsss_Ssss_fsfff_Fssfss_Ffs_S_S_Fs_FS_Fss_SF_S_S_Ss_S_fS_FfFFSff_Sssss_FFF_FsS_Ssss_FSsSs_Fs_Ssss_SS_fffs_Fss_ffs_Ssss_FSS_Ssss_S_Fs_S_Fsffffss_Fs_ss_Ssfs_s_S_S_FfSsss_S_S_
jArrayList5	_Fssf_FfsfssssfFss_FfffsS_FfFsffss_FFfs_ffffFffff_Fssfss_ff_S_Fs_Fs_FfF_Ffs_FFf_FFfS_Ffs_Ff_S_FfffFs_FsffsfssFs_fFfsF_Fsssss_Fsfsf_S_SSs_FfsFs_FfFf_FffsFfs_Fffs_SS_Ffsfs_Fsss_Ffffs_fs_Fsfs_fS_Ffffsf_ss_Fsss_s_Ffs_Fsfsss_Fs_Fffff_
jBa_ques	_s_s_Fs_ssssffss_s_ss_s_fs_s_sss_s_ssss_s_ss_ss_s_s_s_ssssSs_ss_Fs_s_s_ffss_s_s_ssfs_s_ssfss_s_s_s_fs_s_fs_s_ss_Ssfssss_sfss_fss_sssss_sss_s_sSsss_ss_s_ss_sss_sss_s_ssss_ssfss_ss_ss_ssfssssssssssssssss_ssssss_s_Ss_s_s_s_s_s_ss_s_s_s_S_s_ssssssss_fs_sss_s_ss_s_ss_s_s_s_s_s_ss_s_ss_s_
jBankAccount	_s_s_ss_ffssss_ffs_fss_s_ffffs_s_sss_s_ffsssss_s_ffs_fffsssf_s_ffsss_s_ffsssssss_ss_fs_fs_ss_fs_s_ffsssss_s_sss_s_ss_fs_s_s_s_ffs_ss_fssfssfss_ss_ss_sssss_sss_Ss_fssss_ss_fss_ss_ssffss_ss_s_ssss_ssfs_fss_ss_sssfssssssss_sffsssss_fs_sss_s_s_s_s_ffs_ss_f_s_s_ffs_s_fs_ssssss_s_sss_s_fffssfs_s_ss_s_s_sss_s_s_sss_ffs_fsf_Fs_fs_
jBoolean_Method	_FSsS_FSFSFF_fsssfssSssss_S_fsssss_FSFsFs_Ffs_S_fsssss_fs_Fffs_Ss_S_S_Ffs_FSss_FFss_Fs_s_Fs_fsss_S_Ss_Fs_Fss_FssFs_S_Sss_SsFs_Ss_s_Fss_s_sss_SS_SS_S_ssss_Sss_SsFFs_SsS_FSs_FSsss_Sss_FsFs_Sss_s_Fs_FFs_S_Sss_S_S_FS_FS_S_FS_FSs_Sss_Fsfsfs_fs_FS_Fss_F_FS_SsS_FSsssss_Fs_S_
jBoolean_Operators	_S_SSfFSSs_SsssssSss_S_Fsss_Sss_S_S_sssss_S_S_FsS_S_S_S_FSSs_Ss_S_S_S_ssfS_S_ss_Sss_S_Sssssss_S_SssS_SsSs_Ss_S_Ssss_S_sSs_SS_SS_s_Ss_S_SSs_SSS_SS_Sss_Sss_SSfs_Sss_S_S_s_S_Sss_S_S_S_S_S_S_Ss_SsS_SsS_Ss_S_S_S_S_SsssS_Ssss_S_S_
jBoolean_Operators2	_S_FFfss_FFsssFsss_ffs_Ss_ssS_Ffs_FFs_Ffsssss_Fs_Fs_SS_fs_S_Fs_FSfFs_Ss_S_FFFf_Fs_FSfssssss_S_FSs_Fs_S_Sssffss_S_Fss_FFSssss_Fss_FSs_Fss_S_FfsSs_SFsFFss_SS_Fs_FSs_S_FfsfF_FFsssfsFs_FsFS_F_FSssss_FsFs_FSs_Fs_FFs_ffs_S_Fs_FF_s_FFs_S_S_s_FSs_FsFs_FsFs_FSs_FFs_S_S_Fs_FSS_FSssfssss_S_S_
jBoolean_Operators3	_S_Fss_fssssss_s_Fsss_fsf_fsf_fs_fssssss_s_s_Fss_s_S_Fs_FsSFs_ss_s_F_Fs_Ssss_Fsss_Ssssss_FF_fss_Sssss_Fs_Fssss_FsSss_Ss_Ss_s_S_sss_SFs_S_Fs_Ssss_FssS_FSsssFfsf_Fsss_Sffs_Fssf_FsFs_Fsss_fs_S_s_s_Sss_s_fs_s_Fs_S_s_s_ssfs_FsSS_Fss_S_S_s_s_Fssss_fsssfss_s_F_
jBoolean_Var	_S_Sfs_FsssSSss_Ss_Fsss_fff_F_S_sssss_S_s_Sss_s_s_S_SsS_ss_s_s_S_Ssss_s_Ssss_S_S_SsFS_S_Ss_SsSSfss_Ss_s_SsSss_s_SSs_S_F_SS_SSS_S_ssss_FsSsS_Sfff_SfsS_SS_Sss_Sss_FsS_Sss_S_fs_Fs_s_Sss_Fs_S_S_Fs_S_s_Ss_ffs_SsS_Ss_S_S_s_s_Sss_Ssssss_S_s_
jClass1	_s_SFs_ss_Ffsssssss_s_s_fs_s_s_Sss_s_ssss_s_s_sss_S_s_S_sssssSS_ss_S_s_s_ss_s_SS_sssss_s_fss_s_s_fs_Fs_s_s_Ss_SSs_SsFFSssss_s_ss_fFssssssss_fffssssSsss_s_SsSs_ssss_Ssss_Sf_sS_sssssss_ss_s_ssfs_Ssss_ss_ss_sssssssssssf_Fsssssssssssss_S_Sss_S_S_s_s_fss_sssssssssssssss_fs_s_S_s_s_ss_ssssss_Ffs_ssss_ss_sFss_s_ss_s_s_Sss_Fsfs_S_sss_Ss_fsss_S_S_
jClasses_Getter	_S_S_Ss_SssfffffSss_Fs_Fsss_S_S_Fss_Fsss_S_Fsss_S_S_FssS_S_S_S_FssfsssSS_Fss_S_S_S_FsS_S_S_SssSS_Fs_SsSsssss_Fs_S_S_Fs_Fs_Ss_SS_SsSssFS_FsfsS_SS_SSSssFFfFFsS_SFsS_S_SSFf_SSSSSs_Ff_SS_SS_FfffSsffssSs_SS_SssSss_SssSsS_FsS_FsS_SsssssssSssssssssssssSss_Sssss_S_SsS_S_S_S_FFSs_Fs_Fss_F_S_S_Fs_S_S_Ssssssss_S_FsS_S_SS_S_SS_Fs_Fs_Sss_FS_Fsss_Ssss_S_FssSss_S_
jClasses4	_s_s_fs_ssss_s_sss_fs_s_fs_Sss_s_sss_s_ss_ss_s_s_s_fssffssss_ss_fs_fs_fss_s_ss_fss_fs_sssssfss_s_s_ffs_s_fs_s_ss_fssssss_ss_ss_Fssssss_ssffss_SS_sfsfss_s_S_fffss_ssss_ss_sssfs_Ssfss_fsfs_ss_ssssssssss_Ss_fs_Sss_s_s_s_ffs_s_ss_s_S_fs_s_s_ssssssss_sss_s_ss_s_ss_s_s_sss_s_s_fsss_fs_ss_s_
jConstants1	_S_SS_FFFfSFFSFSS_FfSsS_FFFS_SFSS_S_FFS_S_FSssSss_S_FfFfSS_FfF_S_FS_FS_S_S_FfFSFSFfSsssS_FSS_S_FS_S_FFSSFfsS_S_S_FSfSSs_S_SSSsSsssffSsSs_FSfSS_SSsS_SS_S_SSsSs_FSS_S_SS_FSFSSSSS_ffFfF_SS_SSsSsS_S_FFsSss_SSFSs_FsFFsSSSS_S_S_FFsS_SsSsFfSs_SSsfsS_S_SSSS_FfSSS_FFSFfS_SFS_F_SS_S_S_FS_S_FFsSS_SS_SsSs_FS_FS_S_FS_S_FFsss_SfSsS_Ffs_SSFS_S_S_S_S_FSSs_S_S_SSS_SFffSfsFSFSSsSS_S_
jConstants2	_s_S_FSSs_Ssss_s_Sss_sS_S_s_fssss_S_Ssss_s_s_s_Ss_S_s_fsSffsssss_sfFfss_S_s_s_SsFSS_s_S_sfS_S_SS_FfSs_Fs_Ss_ss_fs_fs_SS_SsssS_sFs_s_sfsss_SSF_Fssfss_F_S_sFs_SsssSs_SSS_S_ssSs_S_Ss_SS_S_s_S_Fs_S_s_S_S_S_S_S_S_s_Ss_Ssss_Ffs_sS_s_s_Fs_s_S_S_s_SSfSSss_Sss_s_
jConstants3	_S_S_FSS_SsSs_Fs_SSs_SS_Fs_S_SSSs_S_Ssss_S_S_FSS_ss_S_S_FsSSsss_Ss_S_S_FfS_FSSSS_S_S_SssS_S_SsSs_SFS_S_FSssS_FS_FS_Ss_Ss_SsSS_S_SS_SSS_Sss_FFSssSSsFs_SSsSsFS_S_SS_SsSs_SS_FS_SsSs_SSS_SFs_SS_S_S_S_Fs_S_S_Sss_Sssss_S_S_Fs_S_S_Ss_SssS_S_SS_S_S_S_S_Sss_S_S_Fsss_FffFfSssSs_S_
jConstants4	_S_FS_Ss_Ssss_S_Fssss_sFssfss_S_S_fFFssfsssss_S_Sfs_S_S_SFs_S_FFSS_S_fSSssffsss_Sfss_S_f_Sss_SSSS_FS_Ss_fSsssS_S_SSS_FS_FFFFssS_FFSS_S_Fs_SFss_SFsssS_s_FsS_FFSS_Ss_FSsSFFS_SsfsSSSfss_S_S_SFS_Ss_SSS_FS_SsFSS_sFFssSfSsss_SS_sss_S_S_FS_s_FS_S_FSsss_SsS_S_S_S_S_S_Ss_fssS_S_SS_S_FS_S_S_Sss_S_S_SsSsss_SFfSSss_S_
jConstants5	_fsss_f_fsfs_fSsssSss_s_fsfsfsss_ffsf_fffffs_fffffsf_fffffffffssssss_s_Ff_fffffs_ffss_s_s_fs_ffFfffF_Ss_s_s_ffs_f_ssffs_s_FSs_F_ffffff_ss_fs_S_fss_ssss_f_Ffss_sffss_ss_FffsfsfSs_ssfsssssfs_s_s_ffss_ssss_Ss_FfS_Sss_ffss_fss_fsfS_s_ffs_sfs_Fs_Fs_ffsss_ss_Ss_fs_S_Fs_S_s_Sfs_fffsf_s_fSs_F_fS_s_fs_Sss_S_s_Ssss_ssffs_fs_
jDouble1	_s_s_s_sssss_fs_fsss_s_fs_fs_sssss_s_fsssss_s_ffs_fss_s_s_s_sssfsfs_ss_s_s_fsfs_s_fss_ss_s_fsSs_fs_s_fs_s_fs_s_ss_sfss_fsssssssfs_ss_ss_ssssfss_fs_ssSs_ffSss_s_s_fsfs_ss_ss_fs_sssss_sssss_ss_sfs_fs_ss_fs_fs_fss_s_s_fsss_ffsss_fs_fs_ffs_S_s_fsss_fsss_ffs_sss_fs_fs_fs_fs_ssss_s_s_s_fsffsssssssss_fs_
jDowhile1	_s_ffsss_ffssssssssss_fs_ssssfs_ss_fss_Fs_sfssss_s_s_s_S_s_s_s_ffsssssfss_ffss_ff_S_sfs_s_s_Ss_fsss_S_fss_fss_fs_S_S_fss_sssS_fs_fsss_sS_fssfs_fS_FSs_s_ssffss_fSs_fss_ssFfs_sS_ssss_Sss_Sss_fs_s_fs_s_fss_s_ffs_Fs_s_f_fs_fss_s_fssss_fs_s_f_f_fsss_FsssSs_fsfffffffffsss_s_s_
jDowhile2	_FSSS_FSS_FFfSsSsSSSs_FSS_FSSSSs_SFS_FSS_FS_SSSSS_FS_FfS_FS_S_S_S_FS_FfSsFSSFFSS_SS_FS_S_FSFS_S_S_FS_FSS_SS_S_FS_FFS_S_S_FS_FSSS_FS_SFFfSsSSSsSSs_FSSSFS_F_FSS_FS_FfSs_S_SSS_SSS_FSFS_SSSSS_FSSS_SssSS_FSS_FS_S_S_FSSS_FSS_FS_FS_FS_S_FSS_S_FSSF_FS_S_F_S_FSS_FSSSSSFSS_S_FfFS_S_
jDowhile3	_s_fffss_fffsssssss_ffs_fssfs_sfs_ffsfs_fs_sssfs_ss_Fs_fffs_s_s_ffs_ffFsffff_fsfss_S_s_fss_s_s_s_fsffssssfs_s_sfss_s_Ffs_ffs_fsss_sfssfss_s_fsss_ss_F_S_fffffffs_s_s_ffsf_fFfssffs_Fss_ssssssss_fsss_Fsss_fs_fs_s_s_fSf_f_fffffsss_Fs_s_fss_fs_ffsff_ffffsssssss_s_f_s_s_ffssfffssfssssfsss_fffff_s_s_
jDowhile4	_Ffssss_FFFFSsF_SSsFFSS_S_Ffssss_Ffs_Fss_FfS_FFfssssss_Fs_FS_FS_F_FS_Fs_S_FFF_FfS_S_FS_SFS_S_S_FFFSS_FFFS_FFFfs_S_Sfs_FsS_S_SSs_FFSSFs_F_F_Fffs_FfS_S_Ss_FSSFs_FFSS_SfFSssssss_FFfsss_Ssss_FS_FfffffS_FS_S_FF_F_Sfs_F_S_Fss_FssS_S_F_F_FS_Fsss_F_S_S_
jDowhile6	_FFFSsssssFSs_FFFFFS_SFSS_FfFFffs_FSFS_FSS_FffFs_FS_Ssss_SsS_F_Ff_S_S_FFFFFsFFFS_FF_FSs_S_Fs_S_S_SfSFS_FS_FsFSFfFFfS_FFs_S_FFs_SS_FS_FFSSssSs_FSSFFFS_FFfFS_SsSs_FS_FS_SS_FfSS_SFFSS_FfFSFFs_SSsS_FFFS_FFFs_S_S_Ss_FfSfsF_S_FfFSSS_FSS_FFFF_FFs_S_FFSS_FfFSssssSsFFssfSss_F_S_F_
jDowhile8	_fsF_FSf_SFFFfF_ffFs_FFFssfffss_SsffFsFF_sffffs_ff_f_F_S_FS_FS_FF_S_FS_FffFs_S_FFffs_F_Fs_Fss_S_F_FfSFSsFffSsFfffFfSsssssssssSss_F_fS_FfFFFfFFffffffS_Fs_FS_Ff_FSS_FffFFFfFfsS_FsSsS_FFfs_FFSs_F_fFffs_S_FS_FFFs_fffssffsfsF_FS_S_Sfs_S_s_FfSffSf_FsffSfSsfFsfss_FFs_F_
jExceptions1	_Fs_S_fFs_S_SFfs_Ffss_FFSsffffFs_
jExceptions2	_Ffs_ffffS_Fffs_fFfFfs_F_Ffsffs_Ss_FfsFf_
jExceptions3	_fFFFS_f_FFFFfsSS_S_fS_FFffff_ffF_fFFFfFffFsFsSs_ffFSs_FfFFFFS_
jExceptions4	_FfsS_Fssss_S_FsF_Sss_Sss_FfssssFfs_
jExceptions5	_Fffs_fsfs_fS_Ss_Ss_fsffs_
jFor1	_s_ffsss_ssfffss_Fs_sss_fss_fffss_s_ffsssss_fs_s_s_fsfs_s_s_s_fs_ss_S_s_S_s_s_fs_s_fss_s_s_s_sssfss_fffssfssss_ffs_ssffssssss_ffSfsss_s_s_ffssss_ss_fss_fssfs_ffsfs_fsssss_fssss_sss_s_ffs_s_sfs_s_fss_s_fssssffss_fs_sssF_S_s_f_s_ffss_fsffsssssfssss_f_s_f_
jFor2	_ffsss_fffsffFS_ssFsssss_fs_sss_ss_ffffssffsf_s_sssfss_s_fS_fs_ssS_ffs_s_s_Ss_ss_s_s_s_s_s_sfs_FsS_fffffSs_ffS_s_s_ffsffsfffsss_s_ffffs_SsSs_ssffSs_S_fS_ssss_fsfss_Fffs_Sss_fffffs_sfsssfsss_ffss_sss_s_fs_sfss_Ss_fff_fffffssfss_s_fssssssss_fsFfss_ffsSs_S_s_f_s_s_ssfssss_s_F_
jFor3	_S_FSSSS_SSsSSsSsSs_S_SS_SS_FFSFFSSS_FS_FSSFSFSSS_FS_S_SS_S_S_S_SS_SFS_S_FS_S_S_S_FFSS_FS_SSsSS_S_S_S_FFSSFSS_SF_S_SSsSs_SSFSS_S_Ss_SS_FFFSFF_SSS_S_SSSSSSSSs_SSS_FSSSS_FS_S_FS_SSSS_S_S_S_FSSFfFfSsSsSs_S_F_S_S_F_S_FFSSSSFS_FSSSSSS_S_S_
jFor4	_s_FfSFSs_FSSfsss_Fs_FSs_Ss_FffssfssS_Ffs_fffffssss_SS_s_SsSs_Fs_S_S_FS_FFsfss_S_s_S_S_S_FFfS_FsFsSssss_FsfssS_Fs_S_S_SssSs_S_FFfFfs_fSFffsffsssSsss_SssSsfs_S_FFfSsss_FfsFSs_S_Ffss_fs_Sssssss_FsSf_SSs_S_S_FSSS_SFss_S_Fss_s_FsSFfssss_FSsss_S_F_S_Ss_FSsfsss_Ffsss_F_
jFor5	_S_SS_SSssSSFsFSsss_Ffs_FFfFF_FFs_FFS_F_FFSsSsFss_F_F_S_S_FS_FFF_FSs_S_FFFfs_S_FF_FFFSf_F_FFS_FFS_FSS_FssFssFsSssss_FSsSF_FS_FfFfSsSs_FFFS_F_FfFfFfFS_SFFFS_SS_FFS_S_S_S_FF_F_SS_S_SsFFSs_FS_S_F_SS_FFFFFFFfFSss_FFFS_
jIfelse1	_s_ffss_fssffssssssssssss_fffs_sss_sfss_fsfsffffs_S_sssss_s_s_ss_Sss_s_fffsss_s_ffssSfss_Sss_S_fs_Ss_Fss_ssss_s_s_FsFFffsSfffsss_fss_S_Fsssssss_Fs_ss_FFss_sfsss_fffffsssfsssfffs_S_Ssss_Ss_fs_Ssss_Ssffsfffsssss_Ffsfsss_s_S_fSffs_ssss_Fssfsss_S_sfsssssss_Fsssssfsss_FsFss_Ss_fsss_ffsFfs_Sss_S_fs_S_s_FfssSS_s_s_S_Fs_S_S_Ss_Ffssssfs_Fss_Fss_fsss_fs_S_s_S_fssfsssssFsss_FFfffsssssss_S_s_
jIfelse2	_s_Sss_ssssssssss_s_fsss_ssffs_fss_s_fffssss_s_s_s_Ss_s_s_s_ss_ssFs_S_s_fs_sfs_sss_s_FSssSs_s_ss_fsss_s_ffss_Ss_fsss_sffss_s_fsss_s_sfsss_S_Sfssss_s_S_s_ssss_sss_s_sssfss_ssssSs_fsss_fss_Fssss_ffsS_sss_S_ffs_S_s_Sss_s_s_S_ffs_S_s_s_fffffssfssssS_Fs_ffs_fs_fs_s_s_S_ssssssss_ss_fs_s_
jIfelse3	_s_sS_ssssffs_s_ss_sss_Ffs_ffss_ssss_s_S_s_ss_fs_fs_s_Ss_ss_s_s_s_s_sssS_fss_Sssffsss_s_S_sssss_S_Ssss_SsSs_SsSs_ss_Sffs_s_s_Ssss_S_Ssfss_s_S_s_ss_Sss_S_sssss_sssSs_Sss_Ss_Ssss_ss_Sss_S_s_s_s_sss_S_s_S_s_FS_s_fss_ssS_S_s_s_s_s_f_Fss_sssssSs_sFFssss_s_s_
jIfelse4	_S_FSfFSfS_sssssssss_S_sss_Sss_Fs_s_Ssffsss_S_S_S_Ss_S_s_s_Ss_Sss_S_s_Sss_S_Sssss_s_Sssss_Fs_S_ssssssS_s_Sss_Sss_SSFFSFSFS_Ss_ss_SS_S_s_SfsSs_s_fFSfSFSs_SSsSs_S_S_ffs_S_SsssSss_SsssSss_SssfssssSsSfss_SFsS_FsS_FSss_SS_Sss_s_S_fs_S_Ss_S_S_S_S_S_S_S_ssS_SS_Ss_S_S_S_S_S_Sssssfssssss_FsssfSFsss_S_f_
jIfelse5	_s_FFSsss_sssssssfsss_s_fsss_fSss_fs_s_fsssss_fs_Ffss_s_SS_fs_s_s_FfffSSss_ss_s_s_s_S_sss_s_S_s_S_ffsss_FS_Sffsfsss_FSFssss_FsfsssS_Sss_fsss_Fsss_Ffsfssss_fs_ssss_S_Sfsfssss_Ffs_FSs_ffs_ssss_FsSss_ssssfsss_FSssfsSfsss_FSSs_fsfS_Fssffs_ffsfsf_sfFFf_ffs_fs_s_ss_ffssFffFssss_F_Fs_S_Ffs_S_s_s_fsfss_Ffss_Ss_Fs_Fs_S_S_S_ssssss_sssfSfSssfsssss_S_s_
jIncrement	_SFSSsS_FSSS_SssSss_FS_Sssss_SsSSsSS_FS_S_SsSSSS_S_S_S_SSS_S_FSS_S_FfsSSs_Sss_SS_S_S_FSFS_Fss_S_FSSss_S_FF_FSS_FS_Ffsss_SS_SSsSSFSs_S_S_FFSS_S_SSssS_SSSSSSSsSSSsS_SS_FS_FFSS_FfSsss_SS_SssSs_SSSSSS_SS_SS_SSssss_SSs_S_S_S_S_S_FSS_SSs_S_FS_S_S_S_FSSS_SsS_Ffss_SSS_S_S_S_S_SSS_S_S_Sss_FSsSsssSSsSSS_S_
jInheritance1	_s_ffsssss_fffffs_f_fsssss_f_f_fffsss_ffs_s_ffff_F_fs_f_ffs_fffs_ffffsss_Ffs_fs_f_fffFs_fs_sfsssss_S_ssfs_fs_fssss_Ffs_ffsfsss_F_fs_Ffs_fs_ffs_ffffffffs_f_ff_ffffs_fss_f_
jInheritance2	_s_ssssffsssfss_FfsF_Fsfssss_Ff_f_ffsffs_s_ffs_F_f_fs_fffs_Fs_fs_fs_s_SSss_S_fs_ssss_ssss_ffs_Fffffss_Ffffs_FSFsf_Fs_ffs_S_Fs_Fffs_ffs_f_Fs_Fs_Ffffss_f_
jInheritance3	_FSFS_FSSFFFSFSsS_FFFS_FSSSSS_FFS_FFFS_FS_sF_FFFFFfFS_FS_FS_S_FSS_FFFS_S_FFFFS_FSSFFSSSsSssS_FFFSFFSFS_FFFFS_FSs_FFFFS_FFFFFFFSSF_FS_FS_F_FFFFFFFFFFFFFFS_FS_FFFS_F_FS_FFFSS_S_
jInheritance4	_S_Sssfsss_Fs_Sssssss_S_FffFs_S_F_F_FfFs_S_FFFss_S_FFS_FFS_SsSSs_SsfFSsS_S_Ffss_FSFS_FFSfFFS_S_FFSss_Fs_S_FFS_S_FS_Fsffsss_F_
jInheritance5	_Fss_fss_fFs_ffffssssss_Ffs_fffs_ffs_ff_f_fFfs_F_fFS_fFfs_Ff_F_fS_fffsssssssssss_fFsFffffss_Ffs_Ffssff_Fsf_FFfFsfff_Ffffff_ffffffs_fs_ffffs_fsfffsfs_F_fff_ffs_F_
jInheritance6	_FSs_FSsSsSsSs_FS_FfFFSSsSF_FS_FS_S_FF_S_S_S_FSFS_FSS_S_FFFFFSfsssfSsFSsssssssss_SSSS_FFS_SsS_S_FSS_S_S_FFs_S_FS_FFS_FS_FS_S_
jInt_Long	_S_FS_S_fssssSffssssFfssss_s_Ssss_S_S_S_sssss_S_Sssssssssss_S_s_sss_S_S_s_ssSS_Sss_S_Fs_S_sS_S_s_ssssfs_S_SssS_s_s_FSsfss_S_Sfs_s_Ss_Ss_sssSssSs_s_Ss_SssSfsssSs_s_SSSs_SsSs_S_SF_SS_SsSs_Ss_s_SssSss_ssssssss_Ss_SS_S_Ss_s_s_s_S_S_Sssss_Ssss_S_S_s_S_s_Sss_Ss_s_sS_Fs_S_S_Ss_SssS_SsS_S_SsfssS_fssffssssss_S_
jInteger1	_FFssssS_SFSs_Fs_FfFfSssSffs_Ffs_FfssfSs_S_FfFs_fFs_Ffffffsssss_S_Ssssf_S_S_SSff_S_S_fS_FSssSS_SFSfs_F_Ffs_S_FFfFS_s_S_sssS_Fs_SFs_S_S_FS_S_FfsF_S_ffsSssfs_FSsSsss_fsfssssSsSsssFss_Fss_SFs_FfSsSFss_SFffsssss_FSFSSs_SSFsfSs_S_SS_fFfffffsfs_FfSsffSs_SS_Fs_SssFSss_SffssffssS_FsS_FfsS_Fsf_Ss_s_FS_Ss_S_S_Ffsss_Sssss_S_FFS_s_S_S_Sss_fsfffsss_Ss_SS_FSs_S_S_S_Sss_FS_S_FfFFFSsfFFF_FFFSsssfssSFfssssf_S_
jInterfaces1	_fs_fffffsss_ffs_fffsssss_f_fff_F_F_fffs_Fs_ffs_f_S_f_f_fffs_F_ffs_F_fsfss_f_F_ffffffffs_f_f_Fff_f_Ssf_Fs_ffssssss_Ssfssfsffs_fffs_ffss_fs_fffffff_fffffffFsfssFs_S_FffffFffffffs_F_Fssss_F_F_fffffffs_ffs_fs_F_ff_F_Fs_fss_FS_
jInterfaces2	_S_FFffsssss_ffs_ffsssss_S_F_F_Ffs_FS_S_S_S_S_FfS_s_S_FFS_fFss_f_F_FffsS_Fs_ffssssssss_FfFSssSsFs_S_Ss_FFS_F_FSsFSSSSs_S_FS_FfFsss_Sss_Ffs_Ffs_Ffs_Fff_FfFfffs_Fs_FFSsss_FF_
jInterfaces3	_Fffsss_Fssssfsss_Fs_FFssfsss_F_FS_S_S_Ff_S_FSS_S_Sss_S_S_Sfsssss_FSSSSFfSfSsf_FFs_FsSs_FS_FFFfffsSsssssSssSs_S_S_FFfSsssss_Fs_Fs_FFs_Fss_Fs_Fsss_FF_
jInterfaces4	_ffs_FFSsssSssss_Ffs_sssss_FS_FS_S_F_F_S_S_FSs_FFSs_FS_S_SSs_SFSSS_S_Ss_S_SSSssFss_S_S_Sss_fffs_S_FS_FFS_S_FSssss_FFS_
jInterfaces5	_S_SsFFS_Fffs_Fssfsss_FFFS_S_S_Fff_S_S_S_Ss_S_FffssfsSfssss_SSsFS_FS_Ss_Ss_SFffFSfs_S_S_Fsss_Fffffs_FFFfffs_S_FFSFS_S_Sf_SS_
jMathFuc1	_FsssS_FSs_ssssss_Fs_sssss_ssSfs_Fs_Fs_Fsssss_s_S_S_Fs_S_Ffsss_S_FsFFs_Ss_SSs_S_S_fsS_sss_S_Sfsfs_S_Fs_Fs_FFFs_S_ss_SssssSs_S_ss_S_S_SsfSss_FSs_Fss_s_FsS_Ffssss_SSs_SfsFss_FsFssssss_SS_FsS_Ffssss_Ss_s_S_Ffs_S_S_Fss_Ffsss_s_S_S_S_s_Ss_fsS_Fs_sS_Fs_S_S_S_Sss_S_s_SSFfsfss_FsSssSss_Ffss_
jMathFuc2	_s_sss_sssssffssssss_fs_sssss_ssss_S_s_fsfssss_s_s_s_sS_s_S_s_ffSs_ss_S_s_s_ss_ssss_s_Ssss_s_S_ss_s_S_sss_sssfssS_s_s_s_ss_sSss_sSs_ss_s_sfs_ssss_ss_s_ssssssss_sssssss_ss_ss_sSsss_ss_s_s_s_S_s_sss_sss_s_S_S_ss_s_ss_fss_ss_ss_s_s_s_s_sss_S_s_Ssfsss_FSssssss_s_
jNested1	_s_ssfsSsFs_SSssssssss_S_sss_ss_Sss_s_fsssss_ss_s_fss_S_S_s_fFfffssS_Ss_S_s_Fs_s_s_S_ssssf_S_Fss_s_s_S_Ffs_Ss_S_sss_s_Sss_S_S_Ffssss_SSs_ss_sss_s_Sssss_fsSs_sss_fs_s_ssss_sss_ss_s_fs_ssffssssss_s_Fs_s_s_s_S_sssSs_S_s_
jNested2	_FfsfssssfffSs_fffffffffsffssffFF_fFSffFffS_fs_Sfsff_fffsff_ffffsf_f_fFfssfss_Fsffff_F_fff_Ffs_FS_FF_FffFfffSsfffffffffffs_Fs_S_ffs_S_ffs_fffff_S_fffF_FF_FfffsFfF_s_F_fsfff_FFFs_F_fSfSfsSss_FfFSFsF_F_fsFF_FfffssS_SffSffsss_Fff_FFFsff_ffffs_F_FFffsffs_FF_fffFfs_s_ffffFs_ffsf_fffffsfsfsffsffsf_s_FSfsfss_fsfSffs_ffssF_fFFfF_s_s_sf_ffsfffsssssff_ffffFfs_F_
jNested3	_s_FFF_FfFfSsfffssssss_Fffs_Ffff_Fs_fffsf_Ffff_F_f_FFs_FS_FFs_F_Ffffs_f_FFfF_F_S_S_F_FfFFf_F_fFs_Ffffff_S_FFffssfssssss_FFFssFfFs_S_FfsSssss_FFSfsffs_Ffs_FF_FFs_FSFFSfSFSSfFFFFsssss_Ffsff_Fffs_S_FSs_FfFffffFSsssS_s_FSfsssffffSsFfFfFfff_s_FFs_FFFssfss_F_f_
jObjects1	_fssfss_fs_ffsf_FfssssssfsssFsss_fs_ff_fsfs_ffsssffffs_s_fsss_FsF_ffs_fsssssssssssfsssssssssff_fs_fs_fffsssssfs_fs_fss_fs_fsfffss_fsss_Fs_fs_Ffsfss_Ffs_fs_fss_f_ffssssfss_fs_fsfsss_ff_fffs_s_f_fs_fs_fssssss_fssfsfssfs_fss_fsffs_fsssssssS_fs_ffssfssss_fffssfsfsfs_fssfsss_fssfssss_fs_fss_fsfs_ffsssffss_fss_fs_fssfsss_fsf_fsfs_fsfs_fssssssssssssss_fss_fs_fsss_fs_s_s_fs_fss_Fssssssssssssfsss_ff_fs_fs_Fss_ff_Fs_fsfs_fsss_fsFs_ffs_fsfs_fs_Fss_fs_fss_Fss_Ffs_ffsfs_sss_Fsfs_ffs_fs_
jObjects2	_FSsS_FS_FsfsSsS_SssSs_Fss_FSssssFsf_ss_FsSFF_Fss_sss_FFffff_Fs_SffSssssssssss_fs_S_fssssssss_S_S_S_FsSS_Ss_S_s_ss_ss_FfS_S_fsssssssss_S_SsSSS_S_s_S_FF_s_fs_SssSs_FFsssSSS_ss_Ss_FFsSssSS_s_fSsSs_SsSSs_FssfsS_SSss_S_Ss_fss_Ffssss_Ss_Fs_SsFsSs_sS_SS_SS_ssssssssss_Ss_S_Sss_Fs_S_s_S_Ss_SsSssSs_Sf_S_S_S_Fs_FS_SF_fsss_FssS_s_sFs_FS_Ss_S_S_Sss_SS_S_Sss_FfsSs_Fs_Fs_
jObjects3	_Fssfss_FS_FFSsssFF_FssssS_Fs_FFffFFsssssssssS_sf_FSSF_FFfsss_Fssss_Ss_S_FSssssssssss_S_S_SsS_Fs_S_s_sFs_Ss_S_S_S_SS_Fs_Fs_SsSss_Fs_SsSS_fss_fss_s_Ff_Fs_fss_FsssssssS_SSSSSFs_Sss_Fss_Ffssssssfssss_fs_sSs_SsSSsSss_FsS_Fsssss_Ffs_FSSFS_FsFf_ffssfFfssss_SS_S_SsFsssS_sss_SS_FsFS_FSssssfsssssssfsssssSss_Ffssss_s_Fsss_S_S_s_S_Ss_FfssSSss_FS_Fs_S_FFs_S_S_FS_fssssss_Fssfs_s_FssS_FS_FsS_S_Ffs_Ss_Sf_Ffsss_Sss_FSsfss_S_S_
jObjects4	_S_FS_FSsss_SsSsss_Fs_FSsssss_S_FFSsfSS_S_FSsss_Sfsfss_S_FFfffSssssss_S_FS_FFssssss_S_Fss_Ffs_FSSFS_Ss_S_S_S_SS_S_S_SsFs_S_SsSs_S_S_FFS_F_S_Ss_Ssssss_FFSssSSsS_Ss_SS_FSSsSss_S_Ss_SFFSfSsFfSssS_FSfSS_FfsFfss_S_SsS_SS_FfSs_SFs_FS_SsSS_FFSS_Ss_SS_FSsfssssssssssss_Sss_Fs_Ss_S_Fs_S_S_S_Ssssssssssss_S_S_S_FS_S_S_SS_ffssssss_SsS_S_FsFfS_FS_SS_S_FS_SssS_SS_S_Sss_FFfSsSsS_FS_Fs_
jObjects5	_s_s_s_ssf_s_sf_ss_fsF_s_fss_s_s_ffsssf_s_s_sss_s_s_s_sss_ss_s_s_s_fss_s_s_ssf_s_ssss_s_ff_s_s_ff_sss_sss_sssfsss_s_ss_SFssss_s_sss_fSffSs_sss_ss_ss_s_fss_ss_ss_s_sss_ss_ss_ss_ssssssssssssssssssss_s_s_sss_s_s_s_s_s_ff_s_s_fs_s_s_fsffs_ss_sfs_s_sS_s_ss_s_s_s_s_s_ss_ss_s_s_
jOperator1	_FSsS_SSfFSsfS_FssSsFFSsSsssFSss_FfFS_SssSs_FSsfSFS_SFffs_FFSS_FFSsfSSss_FS_S_S_SS_S_FSS_FS_FSffFSSFfsss_Ssssfss_S_FfFfs_S_SS_SSFSs_S_SFSSss_S_FFFSS_FS_S_FSsss_SSS_SsSFSSFS_S_S_F_S_FSSsss_FFSSSFSSFFSSSssSSsSsssSsSSssSssSs_FSFSsSsssSSFSsSss_Ss_SS_SssssSs_FSS_FSSS_SfSFSsSssFSs_SSSssS_Ss_SS_SFS_SSs_S_FS_S_FS_FS_SSS_FSsSsSs_S_S_S_S_S_SFS_FsffSsS_Ss_SS_S_S_FS_FS_SsSs_S_FfssS_FSsSs_SffSfFFFSSSSFFfSsSFSsssSsSsSSS_S_
jPrimitive_Float	_FssfSS_S_Fs_FFfSsssSsssss_FFs_sss_FFfS_fS_s_sssss_S_Ssff_S_s_sS_S_S_s_FfSSs_ss_S_Ss_S_sss_s_S_sss_S_FFssSSsSsfSs_S_s_S_FFfS_Ss_FfFfS_SS_Ss_ssSssss_s_Ss_SsFFsssss_Fsssffssfsss_SFSFFSs_SSs_s_F_SS_FFsS_FFs_FFsSs_SsfSsSss_SfS_SFs_F_FSsfS_s_S_s_s_S_Ss_Sss_S_S_S_S_S_SfSS_SsS_S_SS_Fss_S_S_s_Sss_S_S_SffSs_ss_S_
jString_to_Double	_s_S_s_Ffsssss_fs_ssss_s_s_fs_Fsssss_s_sssss_S_s_FsFs_s_s_s_SSs_sss_SS_s_s_fsS_s_s_Sss_s_ssss_s_s_FS_Ss_fs_s_ss_Ss_ssssssSs_s_Ss_ssSss_ss_FFsSsfs_Sss_s_S_sS_ss_SS_SSSs_Sss_ss_sS_F_Sss_fs_fs_S_s_s_S_SsSs_s_Fs_Fs_S_s_Ss_FsS_s_fsS_s_S_S_s_Sss_FS_Ss_SsssS_fsSFsss_S_
jString_to_Int	_S_S_Ss_SssSss_S_Sss_FS_SS_S_Sssss_S_Sssssssss_S_s_SS_S_S_S_SSs_SsS_S_S_S_SS_S_S_SsS_S_SSSSs_FS_S_SS_S_Ss_S_SS_Ss_FSsFSsssSS_S_SS_SfssSSS_Ss_SSSSS_SSS_S_S_SS_SsffSs_SS_S_SsSSS_SSSSS_SSS_SSS_S_SsSS_S_S_S_S_S_FSSs_SSs_S_S_S_S_S_SSS_SsS_S_SS_S_S_S_S_S_SSS_SFSsS_FSS_SSss_S_
jString1	_Ffsssssss_FFS_FFsfss_ssFSs_Fss_Ff_Sfs_Ffs_FFffFFs_FfsffffFsssssss_FFS_F_fs_sffs_FS_FS_ffs_SFsSFsS_Fsssss_FS_fs_ffs_FFFFFS_FfFssfFSs_FS_Fss_Ffss_FFffs_f_FFs_Fffsfs_FSsS_FFsssssssS_Fss_FFFfsfffs_FSfS_Ffs_FFSssSs_FSFsffffFs_FFsFFFFSsssss_Fs_FSs_ffFf_FfFff_SSS_FS_SSsSffSS_FFfffssSsss_SS_fsFs_ff_Ss_Fs_Fffsss_FFffs_Fs_S_FfSss_Fsfss_FS_S_FFfs_S_S_Ss_FFffsS_Ffs_FffsFfsss_FFFfSs_FS_FsFsss_fFs_FfFs_SSS_SS_FfFss_FFSsfs_FffffFfSsffffssfSsfFffSs_S_F_
jString2	_fssss_ffsfs_sffsssss_fs_ffsssffss_sfs_ss_s_sssss_s_Sfs_s_ffs_s_s_fs_fssSssss_sss_SF_s_s_ss_ssss_s_sssfss_s_Fss_s_s_Ss_ssss_s_ss_s_Sssss_SsSs_sSffss_s_ffsS_SffS_Ssfs_fs_sssfss_Fsssss_ffsfs_Fsfss_Sss_sss_sS_fsfss_s_s_s_sS_sss_s_fFs_fS_s_s_sss_sss_s_sss_fss_s_s_s_fffffff_fFFsfssssss_s_S_fsfsssss_fsssss_fs_s_
jString3	_s_Fs_ssSs_s_sss_ss_fs_Fss_sssssS_S_fs_fs_Fsfs_s_S_fs_sssss_Ss_S_fs_fs_Fsfs_sfsS_s_sss_Fs_ff_fs_S_Ss_sssSS_s_ss_s_Sssss_SSs_Sss_s_ss_ssss_Ss_Fs_sSS_Fs_Ss_ss_ssss_ff_s_sss_fs_fs_S_ss_ss_s_F_s_s_S_ss_fs_s_Fss_s_F_Fssssss_S_Fs_Ssss_S_s_ffsssss_fssss_S_s_
jString4	_S_Ss_SsssSsss_S_Ffssfsss_SF_FS_s_FsfsfssssFs_S_Ffsf_fs_FSs_S_S_Fs_FFFssS_Sss_F_FS_S_S_FfSsSS_Fsss_SSss_FFss_SsFS_FFs_Ffs_FFFSSSS_FSssSFS_Fss_FSFS_SSS_SS_SSS_SsS_s_FSFfs_SsSs_SS_FfS_SSssSs_FSSSsFSs_SS_FFFSS_SSss_Ssf_fs_SF_S_Fs_FSs_Ffsff_FsFss_FFS_FFs_FFs_Ss_Fs_FSs_FFsssFS_S_FffffsFffsfs_S_FSfSs_Ffssss_Fs_F_SSFFFSsSsSS_FS_S_FFfFsfsSssss_FfSSssfFSsSFSss_Fs_F_
jString5	_S_S_sS_S_sss_sFS_S_S_fsssss_Fs_S_s_ss_s_S_S_sSs_Ss_S_s_s_s_SFs_S_Sss_s_S_FS_Fs_FsssS_sssS_Ffs_sS_s_FSss_SSS_SFssfs_s_ss_Ssss_SS_S_sss_SssSSs_Ss_ss_sss_Ff_ffs_Ss_S_Fs_S_ss_Fs_s_S_S_S_S_ss_ss_fs_FsFs_S_s_S_S_S_S_S_Sss_Sss_S_S_
jString6	_S_Fffs_fsFfsss_fs_ssfsfs_fS_fs_fffs_Sfssss_S_fssss_fS_S_sf_s_S_s_sFsSs_fFs_S_ffs_FFs_Sssfsss_fsss_SFfffsss_Ffs_Fss_Ffs_ffsfs_Ss_FssssfffS_fffs_FfsFs_FS_fsss_SSffsfFFfSssfss_Sfss_Fs_F_sFs_ssss_Ss_ffs_Fsss_SfSSss_Sfs_fsFfs_FffsssFsfss_Sss_sF_ss_Fffsfs_S_s_ssf_FFfSsfSs_S_Fs_Fffs_s_fs_sfss_sfF_s_ffsff_s_Fsf_Fffssssss_Fss_S_s_Fssss_sFsss_FSsssffss_fs_F_
jSwitch1	_F_s_FSsf_S_F_S_S_fS_SSs_S_Sss_SS_FF_
jSwitch2	_FfS_S_S_S_sfsssfss_Fs_Ffss_fSfs_Fs_SSss_S_Ssss_Ss_SfssSf_
jSwitch3	_S_S_S_S_SSSsFsS_FS_SsS_FFfSs_SSfSfSsss_S_SsSs_FFSsFSS_SSSsSsSFS_
jVariable1	_S_S_FFfssFSssFssS_SsssSsss_Fs_FsssFss_FssSs_Fs_Fss_Fsssss_S_S_S_FsFs_S_S_FS_FSsFfSS_Fsss_S_S_S_SS_Fsss_S_Fsssss_Fs_Fs_Fss_FS_S_FSsS_FsssssfSS_ss_Fs_Fsss_S_SSSs_S_SFSsSssssS_SS_FSs_SFs_Ssss_FSSFSs_S_FsssSs_FsFsssssFS_FSS_FsFS_FFfsssFSssfsssssssss_FSSsss_Fs_S_S_S_Fs_Fss_FfSsss_FFsss_FS_Fs_FS_S_Ss_FsFs_Ffs_FsFS_S_S_FS_FSs_Sss_S_Fsss_FSssfsss_FfsSsFsssssFssssss_Fs_
jVariables1	_s_S_fsssssssss_sssssss_ss_sssssssssfs_ssss_ssS_s_sssss_Ssssfsss_s_ssssssssssssssss_s_ss_sss_Sss_s_sss_s_ssssFsS_sss_s_s_ssSs_S_Ss_Ss_Sss_Sss_sSs_sssSs_sss_S_ssss_Ss_sss_fs_s_ssssssSss_sssssssss_s_ssssfssssSsss_sss_SsSSs_ssS_SsSsssssss_s_ssssSsss_s_SsssfsSsss_Ssssss_FffSsfssSsssssssss_sfss_sssssssss_fsSs_ss_ssssssss_sS_fs_Sss_SSssssSs_Ssssfsssss_sS_SS_sssssssssssssssssfsssss_SS_s_Ss_s_s_s_s_S_Ssssssffssssssssss_sssss_s_s_s_s_Ss_ss_ssss_ssS_sffss_sS_s_ss_s_s_ssssss_S_S_Ss_s_Ss_fss_S_s_
jVariables2	_S_S_FS_FSsSsSSs_S_SSsSSsssFSs_SS_S_S_SS_SFSss_S_SsSSS_S_S_SSSS_SsSS_S_S_S_SSSsSS_Ss_S_S_SSS_S_FS_S_S_SSS_S_S_SS_S_SSS_SS_S_S_S_SFSsSSS_SSSsSsFSSSS_S_SSSSSSSSFSS_S_SSSSS_SSSSS_S_SSSSSs_SSsSSSSS_SSSFS_SFSSsssSsS_S_SFSSSs_SSS_SS_SsSSs_SS_S_S_SSsSS_SSsSSS_SS_SS_SSssSSSssfSssssSSSsSs_SS_S_SS_S_S_S_S_S_SSSS_SSSSSS_S_S_S_FS_S_S_SsssSs_SsSS_Ss_SS_S_SS_S_S_SSSS_S_S_SSs_SS_SS_S_S_
jVariables3	_s_S_S_fsssss_S_FSsssssssssss_Ss_S_S_Sss_Sss_S_Sssss_s_s_ssss_Ssss_S_S_S_ssSs_ss_s_s_FsSfs_S_Ss_S_S_SF_SS_S_S_s_SSs_Ss_Ss_S_s_SsS_SssS_S_SsssssSSsS_sf_SSSSS_SS_SSSs_s_Ss_SSsS_SSSss_SSsSsss_S_SSs_Ss_Ss_Ssssss_Ss_F_Sss_SsssSs_SSsSSsss_Ss_Ss_sfsssssssssssssssSsssss_Ss_s_Ss_S_s_S_S_S_Sss_F_S_S_s_F_S_S_Ss_Sss_sFs_ss_S_Ss_S_S_SSs_S_S_Sss_Ss_SS_s_s_
jVariables4	_S_S_FSFFSSSSSSSsssssss_FSsS_FS_FFSssssssSsS_FSS_FFFSF_S_FSss_SSSs_S_FSSssSSsSsSSsssssSssss_FS_S_SFSSs_SSFs_FFS_S_FF_SSSSS_FSSss_FS_FS_SFS_FS_FS_S_SS_FS_S_FFFSFSS_S_SFFS_SS_Ss_F_FS_FSs_SSsS_S_FFFSFSSSSSFFSs_FSs_SSFSSS_FSSsSs_Fs_FFSS_FSS_FSSSSS_SSFSS_FSFfssssFS_SSS_SS_FSS_FfSsSs_SS_S_S_FSssSs_FSFSsFSsS_SFFS_SFS_SsssssssssSssssssssssssssssssSssssssss_SS_S_FF_S_S_Sfs_FS_FS_FSsss_FSF_FS_FS_FS_S_S_S_SsSs_SsS_S_SS_FFS_FSS_FS_S_SSS_S_FS_SSs_FSS_FSFFS_FS_F_
jVariables5	_s_S_Ssss_sss_Fs_Fsss_ss_SF_s_Sssfss_Ss_s_Ssss_s_s_Sssss_ssss_s_s_S_ssSs_Sss_s_f_sS_s_sS_S_Ss_s_S_SsSss_s_SSs_Ss_S_S_s_Sss_SsssSsSs_s_SssSSssss_s_SssSs_SSsSssS_s_SsSssss_SfssS_Ssss_Ssssss_SSs_SsS_SS_Ssss_Fss_S_S_ssss_sssss_SS_Ss_sssssssssssssSsssss_SS_s_Ss_s_s_s_s_S_fsssfssss_Sssssss_S_S_S_S_S_s_ss_fsss_s_SS_S_ss_S_s_Sss_S_S_sss_Ss_SS_S_S_
jWhile1	_s_fffssfsfss_ffsssfsssssssssssss_fs_fsss_sFs_fs_s_fsssssss_S_fs_fssfs_fs_s_S_ssffssssFssfss_Ssfs_FS_fs_S_fsfs_ss_s_sS_S_sssss_fsss_fs_s_Ss_S_sS_Fs_fss_FfFssssS_s_Fsssss_fss_fs_Ss_FFssfss_fs_FfssssffSs_FssFs_Ssfss_ssfssS_fsS_fssfsss_sFsssf_fsss_ffs_s_fs_fssfss_fss_f_fsssfsS_S_Fs_sS_s_Fss_sfsFsss_fsFsSfsFs_ffss_s_s_fs_S_Fsss_Fssssssfsss_ffssssfs_s_f_
jWhile2	_s_Sssss_ssssssssssssssssssssss_fs_ffssss_ss_fs_s_fsssss_s_s_ss_s_s_s_sss_sssss_s_s_s_ss_s_s_ss_s_SSsss_ss_s_ss_fss_s_sss_s_ss_sFfss_s_sss_fss_Ss_ss_s_ssssss_ssfss_sfss_fsss_Sfs_sssssssss_fffsfssss_ssss_s_s_s_s_sssss_s_ss_s_s_ss_s_Ss_ss_fsfssssss_ffs_fs_fsss_fs_s_s_ssssss_fsss_s_s_
jWhile3	_s_sfssffffS_sssfsffsss_fffs_ffffffsf_ss_ffffffsfs_ffss_ffffsssss_S_ffs_ss_s_s_s_Fsffsfs_fsss_s_fffs_s_fffs_fs_ffsss_sffss_Sffs_fFfsssss_s_ss_fffs_fsss_s_fssfss_Fsfsss_S_fssss_FfSssf_Ss_S_fs_fssss_fSss_fss_Ssss_Ffsffs_FffSsssfsss_fffsfffssss_fffssfsss_S_ffs_s_fsf_Sfs_s_sssfs_s_f_ss_s_fffsss_ffssssfs_FffFfsfs_fss_FFsfsfS_fsss_ff_s_s_ffssfssfsssfssssss_fffffsfF_s_s_
jWhile4	_FsssS_FFsfFFfFSfFfFSsfSfFSFssF_FFfFfSsFSsSSSFsFsss_Fffs_FFFFSsfSFsssf_Ss_fsfsf_S_Ssssffs_FF_FFffs_FSFF_FS_S_FFS_FfssfFSs_SsssFSs_F_s_FSss_Fs_FFsss_F_FSs_FFSSfFFSSFSFSFFfsSs_FsSs_FFs_FSS_FS_Fss_SsS_FS_SFFfsSfsssssss_FfFFs_S_FS_S_SsSsS_SS_FssF_SSSFFss_SS_FSSssS_Fffs_FSss_FFs_FFFs_S_S_FFS_FF_FFfFsSF_Fs_Ss_Fs_Ss_fssfFs_FSssss_FfS_S_FFfsfsssSSs_S_S_FfFsSfss_FFFFSssss_Fss_S_
jWhile5	_FSs_FffFfsffF_FFfFFfFSF_Ffffs_Ffffss_fsFff_ffs_FfF_sffffssssf_FFS_ffs_S_S_S_Fffs_Fs_FS_f_fFfFf_S_F_F_Sff_F_S_FfFffs_FfS_f_FFFs_Fffs_FSFsss_FfFSffssss_FSf_fS_Sss_fFSFs_FfFs_FFFFF_FFs_FFSssss_FffsfFss_fF_fFS_FS_S_Fs_FFS_f_FfFfFFfffS_FFFFfffs_FF_fsf_S_FFfsss_fFfsfs_f_FF_FffSssssssss_FS_FffFFffFsfF_fSfF_
jWrapper_Class1	_S_SsSsssssssSsSs_S_Ss_SFS_S_FS_Sssss_Fss_S_SS_FS_FFss_SFS_FfSsSs_FsSF_S_S_SS_S_Ffs_S_S_Fffs_S_SSs_S_Fs_S_SFS_FfFsS_SsfSSs_S_SSSsS_FFs_Ssss_SS_SSS_SFs_SS_Sss_S_SSS_S_S_S_S_S_FSSss_S_S_S_S_Ssss_S_FfSS_
jWrapper_Class2	_S_ssSffssffFSsssssSffSsffsss_Ffs_Ss_fFFFfs_S_S_Fsssss_S_S_FsS_fS_S_SFS_FfSsS_Fss_S_fS_FSss_S_S_FSs_S_FFS_SSffs_S_S_Fffs_sS_SFs_Sss_SSSss_fS_Ssss_S_SFss_FSsfssFSs_S_Ssss_FfFS_FSfFsss_Ffs_s_S_S_s_FSfsss_S_S_F_S_SSsS_S_FSS_
jWrapper_Class3	_sS_Ssssssffssssss_fs_ss_fs_s_s_fssss_S_s_fffsss_ss_SS_Ss_S_S_S_Ss_Ffs_Fs_FFs_S_sS_Ss_FsFfs_fsssss_Ss_FFs_ssss_S_Fsfs_Fss_s_FSssss_s_fsss_fs_s_S_s_s_sss_S_s_S_S_Ssss_fs_ffsF_
drr38	_s_SssssssS_F_ss_FfS_fffs_fssss_F_fs_S_s_fff_fss_FFs_S_S_S_FFs_s_s_fss_Fssssssss_fs_FS_Sss_Fs_s_FSss_ffs_Fsss_fs_ss_s_S_S_s_Sfs_s_Fs_Fsss_s_Sf_
