dsa24	_Fsss_Ffssss_FSs_Fss_S_S_SFSSs_fs_s_s_s_S_Fs_s_fss_ffss_S_fsss_FS_Fss_S_s_s_FFssss_Fffsss_s_S_S_fss_s_fss_S_S_S_FSS_FSs_FSs_S_S_ffs_Ffsfssss_s_s_S_FF_s_FSs_S_FSFS_s_s_S_FssfS_S_fsss_FSs_s_S_S_s_FSsssss
jhb32	_FSsss_FfSFSs_Fss_fsfs_SSfFSsfS_FFfFSfFfFSsfSfFSFssF_SSs_fffss_FFSsss_FFFFFS_S_fffsffFS_FFfss_Fffs_s_FSsssF_ffs_FF_ss_ssfs_fFF_F_Fs_Sss_FFsf_ss_Ss_Ss_Fs_Fs_Fs_sS_ffffS_FFSFFFFSS_sss_FSf_Ss_FS_fs_FSSSSSSSsssssss_F_ffff_Ssss_FFfss_ss
snb39	_Ss_ss_ssf_s_SffS_Ssssssss_ssssss_FSs_FF_ss_s_s_sssss_s_s_FFS_S_fsss_FFsss_ff_Sfffsfssssffsssssssss_FFfSsSs_FSs_S_s_S_fffssss_s_ss_Sss_Ss_FfssSfFffffSfss_fssss_s_f_S_S_FFfFfSsF_Fsss_F_S_s_ssss_ss_ss_ffSs_Sssss_S_Sss_fss_ss_ss_S_FSss_Ss_sSs_s_Fsssss_FSs_S_SSs_ffFffS_Ssssss_FS_SffssssFfssss_S_ssss_fsssss_FsFsss_ssssffsssfss_FSsSsS_Ss_ssssss_sssss_Ssss_FssSsFFSsSsssF_Ss_fs_Sssfffff_ffss_S_Ffss_ssffss_sss_Ss_fss_S_Ffsfssss_Ssss_sssffsss_ssssssss_Sfssss_f_S_fsss_s_ss_S_Ssssss_fff_ssssss_Ffs_fffsss_sss_Ss_s_ss_Fs_s_Sss_FFf_sss_ss_S_Fs_s_Fss_FfSS_ss_Ss_Sss_sss_ssss_SSssS_ssss_sssffssssss_ss_Sss_FFfSsss_SffssffF_FfSs_Sss_ss_sss
nrg14	_ff_Fffs_fs_FFs_S_FS_Fs_Fs_FFFS_Fffffs_Fffs_S_S_fs_ffs_s_s_FfFFffs_fs_Fss_Fs_S_FfffffFfFs_fffs_S_s_s_FfFS_Ffs_ss_S_fs_FSS_s_fs_Ffffs_Fss_s_S_Ffs_S
pmp27	_FFSss_Sss_FFssfffss_ff_Fsss_FFfsss_fsss_f_FFF_SSsS_sssss_SFSS_Fsss_sss_fsss_F_fsf_F_FS_fsss_Sssss_ssss_Ssss_sss_sss_ff_FS_s_Fsss_Fsss_F_FSSS_ffsssffss_FfssfSs_SssSs_Fssss_fsss_Fss_SsssFSs_FfFsffss_Ss_SsfSFsssf_FSs_ffssss_ss_FSsssss_fffffsfsss_FFfFF_fffss_FFffF
rdp23	_F_fS_S_s_S_s_fs_fs_s_f_f_Ssss_S_S_s_s_s_fs_S_S_S_fs_s_Ffs_Fs_FSs_ss_s_s_Fss_FS_s_fs_f_fs_f_fFFFfs_FS_S_SsffFs_Fs_S_S_Ffs_Fff_Fs_s_S_s_S_S_FFfS_s_Fs_s_Fssfs_FS_s_FS_s_s_S_s_s_s_FFFS_fs_s_s_s_S_s_fs_fs_S_S_S_FS_FS_s_ffs_FS_s_F_S_s
mjm248	_S_FfFSF_FFSsfS_FFS_FSS_F_Ffs_ffffFffff_ffffffsfs_F_Ffs_s_fs_s_f_fsfsffffs_Fs_sffffs_S_F_FFSFFSSS_FFS_fs_fsf_F_fss_fffs_Fs_F_S_s_ffffssffsf_FSS_S_fsss_S_S_S_Fffs_ffffs_F_f_fffffs_fs_fs_FsS_ffFs_FffFs
ams396	_ffff_s_S_f_fFfs_S_fs_S_ffss_s_f_S_s_ffss_S_FfS_s_s_FS_S_S_fFs_S_S_Fss_FS_s_s_FFs_Fss_S_Fss_fs_FS_S_FFSS_S_s
jmk195	_Ssss_SSSSS_sssss_Sssssss_Fsfssss_fsssss_Ff_fsssss_f_FsfsfssssFs_fFFssfsssss_Fssfss_ssss_fssss_Fsssss_FSss_ffsssss_fsssss_FfFFSSsSF_fssss_sssss_sssssS_ssss_ff_fsssss_ffffssssss_Sss_Fssss_Fsssss_sssss_FSSSSS_Fsss_sss_sssfss_FFSsfSSss_fFfssfss_ffsssss_Ffffffsssss_fssssss_fsssss_ffssss_SsSSSS_Fsfsss_sssss_sssss_Fsssss_sss_sssss
mac276	_F_Sfs_ffffSfss_s_fs_s_s_s_S_F_F_s_S_F_F__S_S_fs_fS_S_S_S_f_S_FFS_s_Ffss_S_S_FF_s_s_FfF_S_S_F_SS_S_FfS_S_fs_fs_s_FS
hwf2	_FFffs_FS_s_S_s_S_s_s_Fffs_S_ss_s_S_fs_s_s_ss_S_S_s_S_S_fffffs_fs_F_s_ss_FS_s_s_s_
mhr19	_Sss_S_s_S_Fs_Ss_f_FS_fFf_Fs_S_fff_s_fsf_fs_S_s_s_Fs_S_s_s_FFsssss_S_SS_fsssssss_ss_f_Fs_s_fs_fffsssss_S_fs_F_F_S_ss_s_s_f_S_s_fs_S_Ss_Ss_s_F_S_f_s_S_fs_f_s_S_ssss_S_Ff_s_S_S_ffs_ss_F_Fs_f_S_s_s_fs_S_Fs_Fs_s_s_FF
rwm27	_fs_s_S_S_fS_FFS_Fs_FS_S_s_s_S_S_s_s_s_s_S_Ffs_s_S_s_S_S_fs_ss_S_S_s_S_s_ffs_FS_S_S_s_s_S_S_FS_S_s_Fs_s
mlk93	_S_FS_s_s_S_fs_FS_s_S_S_sss_S_S_S_S_Ffsss_S_FffSsss_F_S_S_s_s_FS_S_S_s_S_Fss_fffsss_FS_S_FS_Ffss_s_ss_ss_S_s_S_S_s_S_FS_s_s_FSS__ffsffs_F_S_Fs
kko4	_f_S_F_FFS_FF_S_ffs_S_s_S_fs_S_S_s_s_FS_Fs_s_Ffs_s_S_S_s_S_s_ffs_s_s_Fs_fS_fffs_S_s_s_s_FS_FS_FFs_ffs_S_s_Fs_fS_ffs_FFS_FS_s_ffffs_s_F_s_Fs
afd10	_s_sss_S_ssffss_FfSs_Ss_s_F_F_Ff_F_FSs_S_f_FS_FSS_S_fss_F_Fsf_s_fs_FSss_F_S_fffs_S_F_s_Fs_FsS_S_S_SS_Fs_s_sss_F_ss_Ffsss_S_Fss_fF_s_S_Ss_Ff_F_S_F_fff_ff_S_FS_S_Fs_f_Fs_ss_S_ss_ss_s_s_FF_Ss_ffF_s_fFs_fs_F_s_FfSsss_s_FSffF_ss_F_S_S_ss_S_FFSS_S_f_F_F_S_Fss_S_F_s_s_S_F_s_S_s_s_S_fss_S_S_s_Fss_FfffSS_S_s_FfS_S_fs_Ffffss_F_s_fs_s
mjd78	_s__ss_FSSss_Sss_F_S_Sfss_Ss_Fss_fss_Fss_S_Sfs_sfFfss_ffs_Ss_Sss_f_Fss_S_FFss_Ssss_ss_ss_Fs_Ss_ss_Sss_Ss_ss_Ss_Ss_Ffffs_Ssfs_Fsssss_ss_Ss_fsss_Ss_Ss_SFS_ss_fFs_fssfs_sss_FfS_Sss_Sss_S
sws19	_S_F_S_s_FS_F_S_F_S_S_Fs_S_S_S_S_s_f_F_S_f_s_SSs_S_S_S_F_S_FS_f_S_s_S_S_S_f_S_f_S_s_F_f_F_S_F_S
rkh9	_fs_s_ffs_FS_s_s_s_FS_s_f_s_S_S_Fs_ffs_fff_fs_Ffs_s_fffs_fs__s_s_s_S_S_FS_s_s_f
skm37	_s_S_s_Ss_s_S_s_s_S_s_s_s_fs_Ff_fS_s_FF_fs_S_ss_f_F_Sss_S_s_F_fss_s_s_S_Sss_f_F_s
ril13	_s_FfS_Ff_S_S_fs_S_Ffs_S_Fs_fs_s_fFFFS_fs_fffs_S_S_s_fs_Ffs_Fff_S_S_s_S_fs_Fs_S_FS__FS_S_s_S_S_Ffs_s_ffs_S_S_FS_S_fs_s_s_S_S_S_S_Fs_FS_Fs_Fs_S_s_f_s_FS_FsS_s_FFFFFfFS_s_fs_ffff_S_S_Ffff_fFfs_s_S_s_FFs_S_s_S_fs_Fs_S_FfFFS_s_FF_fs_FfsS_S
jrw98	_ss_s_FSfsssss_S_S_fss_S_s_s_S_ss_S_Ss_sss_fss_S_fs_S_FSfS_FFsss_s_ss_fFSs_S_Fs_FSFS_s_ffssss_Ssss_fff_S_ss_Ss_S_Ss_S_Ffs_S_s_FFFss_s_sss_S_ss_SsS_ssss_fsssssss_S_ss_S_S_s_ss_Sss_FSS_Fs_s_Ss_s_FfSsS_S_S_ss_s_S_S_s_S_fs_S
jme42	_FSs_S_s_s_s_s_s_FSs_F_s__S_S_S_fFfs_S_s_S_S_Fsss_s_s_S_S_ffffsss_s_S_S_s_Fss_FSS_fs_s_fss_S_s_S_fss_Fs_ffss_FS_sS_s_S_s_S_S_S_S_s_S
bpc20	_Sssss_SS_FSs_FFF_SFSSss_F_Ssss_Sffs_Fsssss_s_Ss_S_s_Ss_Ss_sssfss_Sss_ss_S_SFfffsss_SssS_s_FFS_ss_Sfsfs_fss_Ssss_SSsss_S_S_Ss_SS_Fs_F_SsfSs_sss_F_ss_sss_sss_fss_Sss_Ss
jdh99	_SfSFS_F_F_FFFSS_fsffssssfs_S_FfSs_FFfS_s_S_S_S_Fs_FFFfFFFFffS_fsss_Fs_S_Ss_F_ff_sss_fs_S_S_FFSS_S_fFfss_s_Sss_s_Ffsf_F_s_fsffs_s__S
wli1	_FsFsSssss_ff_FFffs_s_S_s_f_ss_FsS_SS_Fs_FS_S_Ffs_fss_fffs_s_s_S_S_S_s_ss_S_S_FF_Ffs_S_s_s_S_S_Fss_s_S_FS_SSs_s
aag45	_fss_Ss_Fss_S_F_FFSS_fs_FFFFfsSS_sss_fs_fss_SSffs_FF_s_FSS_Ss_FFSs_F_SSsSS_ff_Fss_S_Fss_FfFFSff_f_Fs_s_Sssss_Ss_Ff_FFFS_Ss_s_f_fsss_FsfssS_S_f_ss_F_F_SSs_F_F_fss_Fss_F_S_ss_SSss_Sss_Sfs__fSs
wag7	_fs_fs_S_s_FS_FS_Fs_FF_FFFfs_s_FSS_Fss_fFs_S_S_fs_s_Fs_Fff_S_s_S_FFFs_FS_S_Fs_FS_ffS_S_S__FS_S_FFs_s_FFs_s_S_F
rde8	_s_ffs_sSSS_S_s_ffs_S_Ssss_S_ffsfs_FSsss_Ss_S_S_fs_s_Fs_FS_s_s_s_S_Ffs_Ss_ss_S_S_s_Sss_Fffs
kbs29	_S_Sss_FSsSs_Ss_S_s_sfss_sss_ss_SS_fssssss_s_Ss_SSSs_Ss_FsssS_SFss_Fffs_Ss_sss_Ss_S_Ffs_F_SssS_SsSs_Ss_FSSSS_FFss_S_ss_Ss_Fss_ss_SS_Ff_s_FFFSSSS_S_Fsssssss
ecu4	_ss_s__ss_Fss_S_S_s_S_SsS_ss_sss_ssss_fsss_s_s_S_S_ss_sss_ss_s_s_S_fSS_s_S_SSs_Ss_Sss_Sss_Ss_SFS_ss_sss_Fs_Fs_S_FSs_Sss_Ss_FSss_s_s_s_SS_s_ss_fsfssss_S_fs_FFsss_fs_FSssss_Ss_F_FSS_Ss_S_S_Ss_FS_sss_S_FFSs_Fsfsss_SS_SFss_S_s_Sfss_S_fs_s_Ss_SS_sss_Sss_fss_f
mjg82	_s_s_Ff_FS_ss_fss_ss_Ffs_Sfs_fss_s_s_fsfff_Fsfs_Ffs_ss_Sssss_sfffsss__Sss_fffs_S_fssfss_fss_Fffs_fss_S_sf_s_ffsss_ffffffssss_s_f_Fss_Ss_ffss_f_Ffffff_FSs_Ss_f_FSS_fss_fss_f_Ss_F_Fss_s_Ss
tar57	_fss_s_S_S_s_S_s_s_s_s_S_s_S_S_s_S_Fs_S_s_s_S_S_FS_S_S_S_fs_S_f_F_s_S_Fs_Ss_s_S_S_Fs_S_s_s_S_S_S_s_s_s_s_S_S
clk93	_Sss_s_FF_f_s_F_s_Fsss_Ffss_S_Ss_ss_S_ss_SsS_s_Fs_Fss_sss_s_Ss_FSS_ffsss_fFs_s_S_sss_s_SS_f_Fss_fffssfssss_S_f_S_F_S_ss_sss_s_fs_S_SSS_Fsfss_S_SF_Ss_s_s_ss_SSsSs_S_fffFs_Fssss_s_S_S_s_Sfss_Fs_FFfFF_S_s_s_S_fsfs_S_s_FSSsSs_Ffffs_Ss_Sss_FS_SSS_s_S_SsS_F_FFSss_s_S_Sss_S_FFSS_S_S_Ss_S_ss_fFsss_FFF_FF_S_s_Ffsfssss
mjf68	_fs_S_Ffs_ss_s_S_fs_Ffs_FS_fs_s_s_fs_f_f_s_fs_S_s_S_S_fs_S_S_Fs_Fs_FS_FFFFS_S_fS_fFfFfs_S_FFS__fs_FfFs_s_S_s_fs_Fs_FS_S_s_S_s_s
res106	_s_ffsss_Fs_Fssssssss_sss_S_s_s_SSs_s_ss_s_FS_S_Ss_S_SsSS_fs_ss_ss_s_s_FffsssFsss_S_sfsss_S_S_SSS_ffs_ss_fsss_ss_Ss_SSs_Ffs_SS_fssssfsfsssssfssfssss_FFfsSfsssssss_ss_s_fs_Ssss_Fffsssssss_S_s_fSfSfsSss_s_SssS_FFsSss_s_fffsss_S_s_f_S_sss_S_FS_ss_S_SS_S_fsssss_s_s_FF_FffssfsSfssss_s_FFS_Ss_fSFffsffsssSsss_s_s_Ss_SsSs_Ss_Ssss_s_ffssssss_sss_ss_ss_Ss_s_FSss_Ss
jah208	_s_s_S_S_FS_S_S_s_S_S_S_s_S_S_S_S_s_S_fs_s_s_fF_FSs_F_S_S_FFSfSs_S_Ss_s_s_FSs_S_S_S_S_s_fSs_S_S_S_S_S_FFSss_f_S_fFSfS_Ss_S_S_f_SssssS_s_S_S_Sss_S_S_s_S_Ss_Fs_s_S_FFS_Ss_FS_FS_s_F_S_FFs_s
mad205	_s_SFSS_fs_s_fs_SSs_Ssf_Sss_ffs_s_Fs_Fsfsf_s_FSs_s_S_SSSS_ffs_s_S_s_fs_S_Ss_Fs_S_F_s_fS_S_s_fss_ss_Fs_FfSfSsf_FFsS_S_f_Fffffs_fs_FfFFs_S_fs_s_fsss_s_S_Ss_FFss_s_s_Ssfs_S_S_fs_S_S_S_s_SS_S_FSsSF_Ss_SS_s_S_S_Fs_ss_S_fs_fSs_S_S_S_S_f_FFs_S_fssss_S_SFSS_s_FS_S_F_S_s_F_S_ffS_Sss_F_S_fFFF_s_s_s_S_Ss_FfFSFsF_S_ffSs_S_S_SFss_s_fs_Ffs_FS_ss_s_s_s_s_S_FSS_s_S_FS_s_S_fsss_s_s_Ssfss_s_s_fs_S_S_F_s_S_FfSssf_fs
rhl10	_s_Fs_Ff__ss_s_SS_FS_fss_s_Ss_s_Ssfss_s_S_Fss_s_ss_FS_ss_S_Ffssss_s_S_F_Sss_ssssss_s_s_Ss_Fff_s_S_FSs_Ffss
kdd28	_ss_S_S_S_FSS_F_S_S_FFssfss_S_fs_S_S_s_Ss_F_s_S_SSS_S_FS_Ss_S_s_F_S_Ss_FSS_FSS_fs_Ss_SS
ams404	_FS_Fs_s_FFFFS_fs_S_s_S_S_fs_FFs_S_S_S_FFs_fFfffffs_fs_FS_Ff_Fs_s_S_S_fS_fs_fs_f_FS_fs_S_S_S_Fs_S_S_fsFF_S_S_fffs_fS_S_S_S_s_S_FS_S_s_S_FFs_S_fs_FFS_s_FfFFFfFFffffffS_ffs_Fffs_FS__fs_S_s_s_S_S_S_Ffs
jlc201	_FfsSssss_SsSsS_ssss_ffssss_Ss_Ffss_Ssssss_Ffssss_ssss_ff_ss_FfSs_FfS_Ffss_FfFff_s_ssss_ss_FfffSsffss_FfffssS_Ss_Ss_FfFfSsfSssssss_ssss_Ssss_ss_Ss_ff_SffS__FsSs_S_Ss_ssss_ssss_ff_sss_Sss_SsSs_ssss_FfSs_SsSs_s_Ssss_SsffSs_ss_Ff_fssss_ffss_Ss_SsSs_fss_Ssss_ffssfFfssss_ssss_Ss_Ss_FfssssffSs_Ffss_Fs
qim8	_S_Fs__S_S_FsSs_S_fs_FFs_Fss_s_FSs_Fs_S_S_F_Ss_SS_fs_s_s_Fs_FSs_S_S_s_Fs_FFS_s_S_s_s_Fss_S_ss_FS_S_s_Ss_SS_S_FFSsFSS_s_s_S_s_Ffffs_ss_FS_Ffs_fFS_S_S_S_FfS_S_fS_S_s_s_S_S_Ss_FFFFS_S_FS_S_s_S_s_FSss_S_S_Ssss_S_s_FS_Fs_S
brs112	_sss_Ss_ss_Fsss_fss_ssss_sfsss_Ss_Ss_Ss_SfSFSsSss_Fss_Ss_sfs_Sfs_SffSS_FSS_SSs_Ss_Ss_SSs_s_Sss_Sss_FsssS_SsS_s_Fss_Ss_ss_Ss_fsss_Sss_Sss_sssss_SS_sfss_s_SS_sss_Ss_sss_Ss_Ss
alh133	_Fsssss_S_s_s_s_SfFF_sS_s_Ffs_Ss_F_sssss_FFS_SS_Sf_SFS_ss_fFs_Sss_SS_S_S_f_s_Fsss_FfFF_s_s_FS_Sfss_FFSS_FFfffs_SS_S_Fs_s_Ss_S_fs_S_Ffs_SSS_s_FF_fss_s_F_fs_s_s_ss_FFssS_FFFSS_Sss_Sfs_FFS_FFf_sfss_S_Ff_Fsssss_s_SS_FFfs_Ss_Ss_fffffs_Ss_S_SS_S_FFFSS_s_s_S_Ss_S_F_s_ssssss_F_s_SS_S_sss_SSs_ffsf_ss_SffffFfss_S_Ffs_Fs_S_Fs_fffs_s_Ffssss_ss_S_s_s_s__S_ss_Fs_S_fs_Ff_fF_Ss_fs_s_FSSS_fs_Ff_sss_S_SSs_F_s_fss_Ffs_Ffs_F_ss_FS_ss_S_FS_ss_ff
anv35	_S_s_S_S_Fffff_fs_s_s_s_S_S_s_FF_S_s_s_ffs_S_S_s_s_ffs_S_S_s_fs_S_S_s_fss_Ffs_FFs_s_S_s_S_FFFFF_FFss_FSs_S_ff_s_S_S_fS_s_S__s_FS_S_S_S_fs_FS_s_S_s_Ss_S_FfS_S_s_Fs_s_fs_fs_fs_S_s_S_s_s_S_S_S_SS_S_Fs_S_s_S_fffs_S_S_s_S_S_S_FS_s_FS_Fs_Fs_s_s_FFsss_ss
inf4	_FFFffFS_S_s_S_S_S_S_S__s_Fffs_fs_FffFF_s_S_FS_Fs_FfS_s_FS_S_fS_S_s_ffs_s_s_Fs_S_S_S_s_s_ffs_s_S_fffs_Ffs_S_s_S_ffs_S_ffs_fs_Fffs_s_fs_Fs_s_S_fs_fs_FS_FS_s_S_s_Fs_ffffs_S_S_fs_S_S_s_S_Fs_S_FS_s_s_S_S_fs_s_s_s_Fs
jey16	_F_FSssss_ssss_Fffsss_f_s_S_ss_s_s_ssssssss_F_S_s_Ffs_sssfss_ssssssssss_Sssss_S_FfFsss_Sss_ssss_s_S_Sss_sssss_FSssfsssssssss_FS_sssss_FSsfssss_Sssss_s_ssssss_SssfSssss_Fsf_s_s_s_ssss_ssssssssss_Ssss_Ssssssssssss_sss_S_ssss_FSsss_s_s_s_ff_S_sssssss
jdh98	_S_FSsfS_Fssss_S_SSs_SfFSssssss_SFFFS_F_Ssss_Sssssss_sfsssfsss_FSssss_SSSSS_SsSsssssss_Ss_Sss_ffsssss_ff_S_sss_Sssss_FsSsS_Sss_Sssssss_sssssssss_ss_SS_F_Ss_ssssssss_Fssffs_S_F_Sss_Ss_fsssss_SS_fss_sssssssssssss_SSSSSSSSs_Ffssss_ss_Fssf_sffsssss_Ss_Sss_Fsss_Sss
atr16	_FFFS_s_s_fffs_Fs_Ffs_S_fs_Sf_s_S_Fs_ffs_S_fsf_fffssss_fs_FFs_fffs_fs_fs_S_ffs_FFfs_Fs_s_sss_S_FS_FS_Fsssf_S_ffs_fffs_Fffffs_S_s_ss_S_Ss_s_S_S_fssss_s_Ffs_FFFFFFFFFFFFF_FfFS_s_ffs_s_s_FFFfS_fs_FfFS_s_Fs_Fs_fs_s_F_fs_Ffs_Fs_S_ffs_SS
pjs52	_Fsssss_Ss_sss_Ss_fsss_FFSs_sss_SssSS_fssfsss_sss_Ss_Sss_Sss_FSSSS_sss_FSssss_Fsss_sss_ffsss_FF_SSS_Sss_sss_SsS_SSs_FSfFsss_Fsss_Sss_Sss_sfFFf_FSss_ss_SF_Sss
egm18	_s_ffs_Fs_FS_s_FFs_FS_Fs_s_Fs_ffs_S_FFFs_FSs_S_S_Ffs_fs_S_S_fs_Fs_Fs_s_S_FS_Ffs_Ffs_s__s_Fs_s_fss_S_S_fs_S_s_S_S_FfFfs
jhg10	_ffs_s_S_s_S_Fs_S_s_S_S_fs_s_Fs_S_s_FFFfffs_s_Fs_s_fs_S_fs_S_s_S_S_S_S_S_s_s_fs_S_FS_s_S_s_S_S_s_S_s_s_S_Fffs_s_fs_s_S
jdh73	_s_Fs_ffFs_s_s_S_S_SS_FS_Fs_S_s_S_SS_S_FSs_ff_S_s_FS_S_s_s_ffs_s_fss_s_S_S_S_s_Ss_S_s_S_FSsfs_S_S_Ss_s_fs_S_S_S_ss_S_s
leg33	_FFFS_Sss_s_fss_Ss_S_Ss_fS_Ss_FFFs_sss_S_FSS_FfssSS_Fs_Fss_S_Sss_fss_FFS_SSSS_ffs_FF_fss_FFFsSsss_fsss_Sss__sssss_sss_SFss_S_sfs_Sss_FS
kmh117	_fss_ffffffs_fsfsffsf_fs_S_FFS_s_S_s_f_S_S_S_FS_S_s_s_s_S_sfs_sss_S_F_fs_FS_FfFffffFSsss_fs_s__s_FfSfs_FFFS_S_S_FFsss_s_S_Fs_s_s_fffS_FS_S_Fs_S_fs_s_s_SFS
yaz44	_S_S_S_S_ffs_s_S_s_S_Ffs_s_f_fs_S_s_S_s_fs_fsf_F_S_fs_S_s_s_S_s_FFs_s_s_S_S_s_ss_s_s_F_s_S_S_S_f_s_s_fs_ffffff_s_fs_s_s_s_S_s_s_FS_S
bjs49	_Sfs_ssssssss_FSS_FfssSss_sssss_FSfsss_sss_ss_Ffssss_SFS_Ss_ss_S_Ssfs_FSfsss_FS_ssssss_SfSS_Ss_FSSS_Ss_s_ffffSsFfFfFfff_Fss_SSS_FSs_ss__fss_FfFfSsSsSs_sss_fs_fsss_Ssssssss_ssssss_ss_Sss_Ss_FSS_FFfsss_ss_Ss_FSs_fffsss_FSSS_FFsss
chg57	_s_S_fsFfss_s_fs_s_FsffSs_fsfSffs_ss_Ss_s_fs_fs_sf_Ffssss_S_S_Fs_s_S_SsS_f__Fs_s_s_sfs_Fs_s_s_s_s_S_ss_fs_FS_s_Ss_s_S_ff_ff_f_ss_S_ss_Sfs_ss_Fss_S_sss_Ss_s_s_ff_Fs_Sf_S_S_S_ss_S_s_Fs
jky3	_S_S_S_Fff_s_s_S_S_S_Ffs_FS_ffssF_fs_s_Fffs_Fs_S__s_S_S_S_s_S_Fs_s_Fss_Fffffs_S_S_s_fs_fs_FS_S_s_fs_S_fs_S_ss_S_S_s_ff_ffs_Ffs_s_s_Fs_Fs_F_s_S_S_S_S_Fs_s_FSssss_s_S_ss_Fs_s
abr26	_Fs_ffffsssssss_F_s_FFS_S_S_s_s_FSfSs_FSsss_S_s_S_S_FFsfsfS_s_S_FFFFSS_FSs_FS_FS_S_fs_s_S_Fs__S_Fsf_FS_S_s_S_fsss_FS
mjs187	_s_S_s_fffsss_s_S_S_S_fs_S_S_s_s_S_S_S_S_S_S_s_S_S_S_S_s_s_Fs_s_S_S_s_Fsss_s_s_S_s_fS_Fffssssss_FS_fs_S_s_S_sssss_S_Fs_fsss_S_S_s
ang92	_F_S_S_S_s_F_s_fs_S_s_S_S_Ffs_s_FS_S_S_S_s_s_S_s_S_S_S_S_S_S_S_S_S_s_s_FS_s_S_S_
kmt51	_s_Ffss_FfFsSfss_FS_S_S_F_Ffs_S_Fss_S_s_FFSS_FS_S_S_s_s_S_S_FS_s_ffss_Fs_S_FfssS_S_S_sf_FSS_Ss_s_S_ffffs_SS_s_S_Fs_S_Fsss_FS_Fssss_Fss_s_Fs_Fs_S_Fsss_S_s
sbb28	_Sss_SsS_Fsss_Ss_fsss_ff_FSS_F_Sss_ffssfssfsssfssssss_Fsffsss_Fsss_s_Ss_sss_ffs_Fsf_SsSsss_FSS_ffssfffssfssss_fsss_Fsss_Fsfsss_FsffSfSsf_Ssss_Fff_sssss_FS_Ssss_Fssfss_FFSSFSsS_Sss_SsssS_Sssssfssssss_Fsss_F_FFfFsfsSssss_FSS_Ssss_FfFSss_sfssss_FfSsfssss_Sssss_SsssS_SsfssS_FSSSSS_Ssss_fsffssss_FfFFFSs_ss_Ssfsss_SSsS_Fssssss_sss_Sss_Fffs_SSs_fsfsssss_SSFfsfss
sab155	_s_S_fsfffffffffsss_FSsss_S_Ssss_ss_FSsSsssSSs_Ssssss_s_ss_f__FSsssss_s_ffssssfs_fffffsfF_fsss_s_Ffssssf_s_s_s_ss_SFfS_SS_FFfSsSs_fs_sss_FfsSs_S_FSssfssss_s_FSFSSsSS_FS_ss_FsssfSFsss_ssss_Ss_fs_s_fffff_s_s_F_Fss_s_S_Sss_S_fs_fsssfss_Ss_Ffs
rsb45	_S_s_S_S_s_S_s_S_S_S__FF_S_s_S_s_Ffss_s_S_S_Fs_fs_S_F_S_Fs_S_s_FFs_Ffsss_F_Fs_Fs_S_S_S_S_s_s_s_Fs_S
drr38	_s_s_FFS_F_FfS_s_Fffff_F_f_S_S_S_S_S_FFS_s_s_s_FS_F_F_S_s_F_FsS_SS_S_f_F_F_S_F_FFF_S_f_F_s_S
