dsa24	_S_s_S_Fsss_S_s_S_S_s_s_s_S_F_s_S_S_S_s_s_s_S_s_S_S_S_S_s__s_s_s_S_Ffsssss_S_S_s_s_Fss_fs_S_s_FSs_S_FSs_S_s_S_s_fffSs_S_fss_s_Ffsssss_S_S_Fsss_F_s_Fss_s_s_f
jhb32	_F_FSFSFF_ffss_FfsffF_FSSSS_F_SSfFSSs_Fff_SS_Sss_S_ffsss_FSSS_Fs_ffsss_Fss__SsS_FSfFSfS_fsssssssss_FFFFSsF_f_fffssfsfs_Ss_S_FSS_ffff_Ss_sfss_FSS_fsffssf_s_FSss_FFsfss_S_F_ffsfs_Ss_s_FFFfS_s_F_Sfs_Fsfs_FSF_FFSFSS
snb39	_ffsss_ss_Ss_fsss_f_Ssssss_FfFfSss_FfFfssss_Sssssss_s_ss_FFFf_s_sssss_ffs_S_s_Sssss_sfss_FS_Ffss_ssss_sss_Ssss_S_FFfFfSSS_FSsSsSsSs_S_Fffssff_sssfsss_FsFSsss_S_f_F_SsFFS_sss_ss_sss_ssssss_ss_S_fss_S_fsss_ffsssss_FfFfSs_FFSsss_Ss_FFf_Ssss_Sss_Sssfsss_ssss_sssss__ssss_Fsss_fsss_sSs_Sss_Ssss_S_fF_ss_sffss_sssssss_Ffsss_S_sss_sffsss_s_fsssssssss_Sffs_ss_Ss_sss_ss_fssffsffssss_Sss_f_ffss_fs_sss_fssff_FSSFFFSFSsS_SsS_SSs_f_SS_ss_s_fSss_Fs_Sss_ffsss_f_ssss_s_S_sss_F_sss_sfsss_SSsSsSs_fffffs_s_ss_Sfsss_sss_Fffs_ssss_Sss_sffs_S_Fssss_ffssss_Ssss_Ssssss_S_fsss_S_ss_f_ssssssssss_fs_sss_Ss_S_ffffssffssss_fffss_fSsss_fffssssss_fssSs_S
nrg14	_S_s_fs_Fs_s_fs_ffs_FsS_S_fs_Fs_s_Ss_S_FfffsS_FfFfFs_Fss_Ffs_fs_FS_s_Sss_s_Ss_Fs_fffs_S_S_Fs_Fs_Fs_Fffs_fs_FFSS_ffs_fs_Fs_F_s_fs_
pmp27	_sssssssssf_sss_FsssssssssS_ss_sf_ss__Fsss_fsffs_sfsss_sss_Ffssss_Ss_F_Sfsff_sss_Fsss_SS_ssss_Ffff_Ss_sss_Ffffsss_s_SSs_fsss_Ssssssssssss_ss_ss_fss_sssss_SsS_sss_sss_Sss_FFFSs_sss_Ff_fssfs_FSssss_F_ffffffsf_fs_Fsf_Fsss_Ffssfsss_fsssss_ssfsfs_FFSssssss_FSSSSs
rdp23	_FS_ss_ffs_S_s_Fs_s_Fs_fs_s_s_S_Fffs_f_ss_F_fs_fs_s_s_ffs_ff_S__FFfs_s_FfffFs_S_FF_s_fffs_FS_s_ffs_s_SsSSs_fffffs_f_fs_fS_s_s_S_s_s_S_fs_s_S_s_ffs_s_s_s_s_FFs_fs_s_s_fFs_S_s_fs_S_S_s_s_Fs_s_F_S_s_s_FS_Fs_fS_s_f_Ffs_S_fs_s_S_f_s_fs_s
mjm248	_fS_ffs_S_Fs_FS_s_fffsf_fs__S_ffs_ffss_Ffffss_fs_ffffsf_FS_Ffs_ffsss_fss_S_Fs_F_Fss_s_S_fs_FFFS_ffffs_S_Ffs_fsfff_ss_fs_ffsfs_s_Sss_S_ffs_S_S_fffss_FffssfssS_S_S_FFFffFF_fsfsf_FfFs_fs
ams396	_s_s_s_S__s_s_S_S_s_s_FF_fs_s_Ff_s_Fs_F_Fs_s_FS_s_FFs_S_Fss_s_FS_fs_S_F_S_FFfsss_s_fffs_FFffFF_s_fs_fsf_Ffs
jmk195	_fsssss_fss_Fssfsss_sffffssssf_Fssfss_SSSs_fssss_Sssfss_fsfssss_sssss_Ssssffs_FFssfsss_Sss_Sssss_FFSsSsFss_sss_Sssss_fffffffffssssss__sssss_FSsss_FfsffffFsssssss_fsfssss_SS_sssss_fsssssss_Sfssss_fffsssss_fffffssss_fsssss_fsssss_FSSFSFSSS_FFfssssss_FFFSFSSSsSS_sfssss_FSssSss_sssfs_Ssffsss_FFFSsssfsss_fffssss_fsss_Fsssss_Ffsssss_ff_Sss_sssss_ffffsssss_Fsssss_fffsssss
mac276	_fss_S_Ffsf_s_FS_fs_S_S_Fs_s_s_Fs_fss_S_F_s_S_F_Ff_ff_Fs_s_s_s_F_F_FF_S_Ff_S_Ffs_ff_S_s_S_FS_S_F_S_S_S_f_S_fS_S_s
hwf2	_fs_s_s_fs_fs_s_S_FS_S_ffs_S_s_fffs_S_s_s_s_S_ffs_Ff_s_S_ffs_ffs_s_S_Fs_S_s_fs_s_S
mhr19	_SsS_Ss_ff_SS_s_s_s_Fs_S_f_S_Fss_fs_s_s_FF_ff__fs_s_Fs_s_FS_F_S_s_S_s_S_S_f_s_Fs_s_S_Sff_Fs_FS_fs_s_sss_s_FS_s_ff_ss_s_fs_fffsss_Fs_S_f_s_S_sf_S_fs_S_FS_ss_f_F_S_S_S_S_fF_S_s_s_f_Ss_Fs_fss_F_s_Fs_Ss
rwm27	_S_s_fs_FS_S__fs_s_Ffs_S_F_S_s_fs_S_S_s_s_S_s_S_S_ff_s_S_fs_s_s_S_Ss_s_s_s_s_FS_s_ffs_s_S_FFs_fffs_S_S_FS_S
mlk93	_ffsss_S_FFSS_FS_FS_FS_S_FS_S_S_ff_S_fss_S_F_s_S_s_S_S_S_s_S_FF_s_fffsss_S_s_FSS_S_s_s_s_s_s_s_S_s_S_FS_S_S_S_Ffs_S_S_S_FFSS_FFss_fffsss_s_Fs
kko4	_S_s_FS_S_s_S_s_s_s_s_Fs_S_s_FS_FFS_S_FS_fs_FffFs__S_Fs_S_fs_s_s_FS_Ffs_FFFS_S_s_F_S_Fs_FFS_s_S_S_f_fs_s_FS_FFS_FFFFFsF_S_S_S_S_S_S_S_s
afd10	_ss_S_S_FfSs_sss_S_S_S_S_FfSs_S_ffsss_S_ss_F_fss_S_Sfss_ff_ss_S_ffFfffSsffffffff_s_ffss_fsss_f_s_S_ss_Sss_f_S_S_s_ffssss_Ss_F_S_F_s_Ss_Ff_Ss_S_fss_ffss_ffff_Ffs_S_s_s_FF_s_s_s_S_S_F_S_s_FfS_F_fff_fS_s_s_fss_FsS_ss_f_S_S_fs_FS_FSs_FSS_S_FsS_S_fff_ffssss_S__fFff_ssffssss_s_S_Fs_Fsffsf_ff_s_Ffssf_FfFS_s_FfS_S_ss_Ss_F_F_s_S_FF_ffss_F_FsS_Fs_FSS_fss_s_S_F_S_s_S
mjd78	_FSS_ss_ffs_ss_ss_Ss_SFSfs_FSs_SffssffSss_sss_Ffs_ss_FsSF_Fsss_ss_f_FS_S_Ss_SS_FFsfss_Ss_fsss_ss_ss_fsfss_Ssssfss_FSs_ss_sssss_SS_FSs_ss_Ss_Sss_S_S_S_ffss_ss_s_fsss_Fs_ss_Ss_Ss_Ss_FFFfSs_s_S_ss
sws19	_S_s_S_F_S_S_S_S_s_F_Fs_FF_F_S_S_S_f_S_ffs_S_F_S_S_F_S_f_F_S_S_S_S_S_f_F__S_S_f_S_F_S_S_F_S_S
rkh9	_s_fs_Ss_S_s_s_Fs_s_S_S_f_s_f_f_s_fs_s_s_S_F_S_S_s_s_fs_s_s_FfFfs_fs_FS_S_s
skm37	_S_Ffs_S_FSss_S_S_S_FS_sF_s_s_S_s_S_fs_S_FS_F_s_S_FfS_fs_S_S_s_S_S_fs_S_f__ffs_s_S
ril13	_FFf_S_s_S_F_S_fs_S_Ff_s_F_F_FS_S_s_s_S_s_FffFs_fs_Fs_fs_s_S_S_fs_s_fF_s_s_F_FS_Fs_S_s_s_Fs_F_FFFFS_fs_S_FFS_S_FfFs_S_f_FFFfs_F_FF_FS_f_FS_f_ff_fs_FS_S_FF_s_S_FfS_S_S_S_f_FFfS_S_Fs_Fs_Ff_S_s_Fffs_ss_s_Sss_FS_fs_FFs_fs_s_S_S_S
jrw98	_S_SS_ffsss_SsSS_Ss_s_F_S_s_sss_Ss_FfFss_fs_Fss_fs_SSF_Sss_F_f_fSsss_Sss_s_Ss_S_FFS_S_s_s_ss_s_ssf_Fs_s_S_S_ss_S_S_Fss_sss_Ff_s_S_Sss_sfsss_S_s_S_fssss_s_ffs_fffff__f_sf_sss_S_ss_S_s_S_sf_s_fFS_s_sss_s_s_Ss_sS
jme42	_Fs_f_Fss_S_S_s_S_Fsss_S_S_Ss_S_s_Fs_S_S_S_F_S_S_S_s_s_S_S_S_fs_S_s_F_s_S_S_fs_S_FSS_S_s_FF_Fs_s_S_S_FS_S_s_s_s_s_fsss_S_s
bpc20	_SssSs_FFssS_fs__Ss_sss_s_SS_SS_Ss_Ss_SS_Ss_ss_SFs_Ffss_Ss_SFSS_ss_Sss_S_s_SSS_fsSs_SSS_FSSss_S_s_fss_Ss_Ss_ss_Sssffsss_FFffsSfffsss_FS_sssss_Ss_SSss_Ssssss_f_Ss_FSs_SsSsssffSs_sfss
jdh99	_S_Fsss_SFSFFfsSs_FfffFs_sfs_Fs_s_s_fffF_f_FS_FFffs_Sff_Ss_FS_FS_FFSSfFFSSF_Fs_FF_sssf_fss_FSfSS_s_SFS_FFFSf_Ssf_FFs_FSS_s_fsss_S_s_ss_S_fS_Ffs_fs
wli1	_s_S_FFss_s_S_S_s_Fs_s_s_F_S_S_S_s_S_S_s_S_fss_fffs_s_fss_S_S_S_s_s__s_Fs_ffff_S_fffs_S_Fffs_Fs_fs_S
aag45	_ffffS_fffffSs_FS_sfsssfss_fs_Ff_FSsss_s_S_f_ffss_sfss_FS_s_FFFFfF_FS_Fss_FffsS_fs_FfsF_F_Ssssss_Sss_Fs_sfss_ss_S_Ss_ss_FsSs_Sss_FsFSFfFFfS_Ffs_FS_sss_SsFS_Fsssssss_FF_FS_FFFS_Fs_Ss_FF_FFs_ffsss_S_s_Ss_Fssss_Fs_sssS_s_FfffsFfF_ss_SSSsFsS
wag7	_S_Fs_s_s_s_Fs_fs_FFs_S_FFS_S_fs_S_FFS_fs_S_s_s_s_S_s_S_s_FFs_FS_FS_fs_S_ff_s_FFS_s_FfFfS_fffs_s_Ffs_S_s_s
rde8	_s_S_ss_S_s_S_s_ss_fs_Ss_Ffsss_s_s_fs_S_Ss_s_FSs_Sffsfsss_Sssfs_Sss_f_fss_sss_S_S_fss__S_Fs_fs
kbs29	_S_FSsS_s_ss_SssSs_Sss_S_sssss_ss_Ss_s_S_Sss_Ss_Ss_S_ss_fss_s_Ssssss_ss_S_s_S_FSs_fss_SSs_SsssSs_SS_FSFssss_Ss_FS_Ss_SS_Fssss_s_Ss_SSS__S_S
ecu4	_S_s_Ssss_s_S_Ss_fs_s_s_FS_s_FSsss_Sss_Fs_FSs_S_FS_SSFFSFS_fs_s_FF_s_fss_Ss_SsSss_S_S_Sss_Fssss_SSs_s_S_fffS_sfsss_Sss_Ss_S_S_S_s_SsS_s_S_FSFSSSSS_F_S_f_Fsss_sssfs_s_SSS_Sss_s_fss_S_s_fss_s_Ss_ss_sss_ss_s_sss_s_F_s_Sss_Ss_SSS_s_fsss_fss_FSFSSS_FFSss_s_s_FS_FFss_S
mjg82	_s_ss_FFs_s_Sss_fsss_S_FFSS_Sss_s_Fssss_sss_ss_f_S_Sss_FS_Fsffsfss_Fss_fffs_FSS_ffffsssfsss_f_S_f_Ss_ss_ss_FsfsS_Ss_Fs_ss_ffFfF_S_S_FFf_Ss_ffsffsf_Ss_Fss_sfss_s_sS_FFfFfFfFfSFfSs_s_Fss_S_f_Ss_ss
tar57	_FS_S_S_S_S_S_S_FS_s_S_Fs_ffs_S__s_s_Ffs_S_FS_S_S_s_s_s_Fs_S_Fs_FFFfsfff_s_s_s_s_s_fs_fs_s_s_s_S_s_s_s_S_fsss_s_S_S_S_S_s
clk93	_FS_FFs_F_FsS_S_S_S_f_s_S_S_Fs_s_fss_Ss_S_S_fss_FfSs_FFF_Ss_FFssss_s_fFsfs_Ff_S_s_S_sss_Ffsssfss_SS_S_s_S_SssSfsss_sf_FSfS_s_sss_FS_FSS_Fss_fsss_S_Ffsssss_F_s_ss_S_S_s_SS_s_SS__Ss_s_s_Ssss_Fs_Fss_Ss_S_S_fs_fs_fsss_S_FFsSs_Fffs_fS_s_f_s_ss_s_S_F_s_Fs_S_FFS_S_S_sfss_Ss_s_s_Sss_ss_S_Ffss_s_S_FSSs_ffs
mjf68	_S_S_S_ffffs_FFfFfs_S_s_S_s_fs_FFsS_s_S_S_fs_s_fFfs_FFS_S_S_s_F_ffs_FFfS_fffs_F_S_F_S_Ffs_S_fs_s_fS_FFFFS_Fs_S_Fs_S_S_S_F_Fs_fS_Fffs_S_Fs_S
res106	_s_Fsssss_ss_s_s_Ss_sss_ss_ss_Fsss_fs_ffssssssss_s_s_s_s_ffs_s_s_FfSFSsFffSsFfffFfSsssssssssSss__s_Fsssffssfsss_fS_FFFFFSfsssfSsFSssssssss_s_fs_ss_FFSSssSs_S_Sss_s_s_ss_ss_s_S_ss_ss_fssss_sss_Sssss_s_sss_S_fs_S_FFfSsSSSsSSs_S_S_S_Sfsssss_s_Ssss_FSSFFSSSsSss_S_SsfSSs_S_s_Ss_Ss_s_SSsSs_ss_s_sfffsssssfsss_Sss_Fffsssss_s_FFffssfssssss_Fsss_Ss_S_S_fffssssssssss_S_FssFssFsSssss_sfssss_fSss_s_fsssfssss_ssffssssss_Sss_S_S_ss
jah208	_Ss_F_S_Ss_Ff_S_s_s_s_ffsfFFfSssfss_S_FsffffFs_S_s_FfSs_fs_fs_s_ffsfffsssss_S_f_fs_S_S_SSSsSSSsS_FFSs_S_fs_S_FSs_S_S_S_FSSSFSSFFSSSssSSsSsssSsSSssSssSs_fffss_S_Ss_Ss_F_S_S_FSs_S_S_f_s_fs_S_S_S_S_S_s__S_S_S_f_FS_Fffs_S_SS_s_S_S_S_F_S_s_S_Ss_s_S_S
mad205	_s_S_S_S_S_fs_s_fFs_fs_Ss_s_s_s_s_s_s_s_S_fFSffssss_s_s_FFS_s_S_FFssS_s_fFffFsFsSs_s_FS_s_s_s_fs_s_fS_S_FS_S_ssFsfss_FS_fss_S_S_S_Fs_Fs_f_Ss_FFFssFfFs_FSSS_S_FSSSS_S_fss_FFssssS_S_S_S_s_s__Fs_s_S_S_SfSfSsss_Sss_fS_FSsS_FFFS_s_S_s_Ffs_FFFS_s_FFS_Sss_fs_s_FSsSss_Fs_S_s_FFFSss_S_S_ss_s_F_S_s_FSFSsSsssSS_S_S_S_s_SS_Ss_Ss_ss_S_s_Ss_fs_s_S_sS_s_S_sss_fs_F_s_Fs_S_fs_s_S_FSsS_Ss_s_Ff_Ss_sffs_S_s_Sss_fs_S_S_s_FfFSss_s_Fs_fss_s
rhl10	_S_fS_s_Ss_Ss_ss_F_s_sss_sss_FSSsssSs_Ffs_ss_Ffs_S_sss_s_F_s_S_S_S_fssss_FS_F_S_s_Ss_Fs_FSf_s_Ss_S_S_Ss
kdd28	__S_S_f_S_S_S_S_SS_s_s_FSs_S_S_S_s_S_Ss_ssssss_ss_S_S_F_SS_S_s_S_FSs_FS_F_SS_s_FSs
ams404	_s_s_S_ffs_Fs_s_Ffs_Fs_s_Fs_S_fffffffs_s_S_ffs_S_s_FFs_Fs_s_S_ffs_s_S_S_S_ffs_s_s_S_Fs_S_S_s_ff_FS_fs_S_Fs_ffs_fs_S_fs_S_FFfFS_s_S_fS_S_S_s_s_fffs_S_s_s_S_S_S_S_fs_s_Ff_s_FS_Fs_FFS
jlc201	_SsSSs_Ssss_ss_SSs_SssssSs_ss_FFfSsss_Ss_ss_Ssss_ssss_SsSs_FSs_ffssss_ff_ffsss_ss_F_FfSsss_ssss_ssss_ssssss_ssss_ffss_Ss_S_ssss_SSs_ss_Ssss_FfSsff_FfSs_Ss_Ssss_FSs_ssffss_FfFfSsSs_Fffffss_Sss_Ss_SsSs_ssss_Ssss_S_Ss_Ffssss_ssss_SsSs_Sss_FfSsSs_Ssss_Ssss_FSs_ss_sssssssssssffssssssss_Ffssss_SSsss_ss_ssss_Ffss
qim8	_FFS_S_s_ss_S_S_fSs_SS_S_s_S_sss_FSs_FS_s_fss_s_fs_s_Fssfs_Ss_S_s_S_S_S_S_Ffs_S_S_s_FsSs_SS_S_Fs_f_S_S_fs_S_S_S_Fss_S_SS_S_SSsfs_SffSff_s_Ss_S_S_fss_ss_FFSfsffs_S_S_S_S_s_S_Fs_s_S_Sss_s_FSS_FS_S_Ffff_S_S_S_Fs_s_Ffs_ss_Sss_S_Ss
brs112	_SS_ss_Sss_FsSs_ssss_FSs_ssss_fs_fss_ssss_SS_FSss_Ssss_Ss_S_Ssss_ss__sss_ss_ss_FSss_Ss_ss_Sss_fsss_SSss_ss_SS_FFs_ss_Sss_fffffff_SS_s_Ss_sS_s_F_s_SS_Ss_ss_ss
alh133	_S_Ff_F_fs_Ff_ffffFs_SsfSsS_ss_Fs_Sss_SsSs_Sf_FSsss_SsS_S_F_ff_Ff_s_FSs_FSFSs_S_ffs_F_S_FFSsffff_Fs_s_f_F_sSS_SSss_ss_fss_f_s_FSF_FS_FSssfs_s_Fs_f_s_s_sfs_S_S_s_s_S_fss_Sfss_SSS_S_Fff_S_S_Ss_SSSS_f_Ff_Ss_f_s_SFs_Ff_fs_ss_Ss_f_FffFS_s_Fss_FS_Sffssffss_Fss_Ss_S_s_fs_S_f_Fss_fs_f_ss_s_s_s_ffs_s_FS_f_f_SFs_S_fs_Ss_f_ffssS_s_fS_fs_sss_fs_F_FF_S_Ss_S_Ffffss_S_FFFF_sssss_F_s_Sff_Ss_s_s_S_ss_fs_F_fSsss_s_s_s_S_SssfssssSs_Fss_FSSSs_F
anv35	_S_Fss_S_fs_FFS_Fs_S_s_S_fs_S_S_s_s_s_S_S_S_S_S_FS_S_FFS_S_S_S_S_FSs_fs_Fs_s_S_s_Fs_F_fFfs_s_fs_s_Fs_SS_S_s_s_S_S_s_FFFFFS_Ffs_Fs_fs_S_Fs_S_s_s_F_s_FFS_FFFsff_Fffs_s_S_f_S_FS_s_S_Ffs_Fs_Ffs_FSsfss_fs_S_s_s_S_S_Fs_S_fs_S_S_s_s_s_S_S_fs_Fs_S_S_S_S_S_Fs_S_fs_s
inf4	_s_S_s_FS_Fs_fs_ffs_S_s_S_S_S_fFf_Ffs_fs_Ffs_ffffffs_FfFfFfFS_FFFS_ss_S_FFS_S_s_fs_S_S_S_S_s_S_S_Fs_fffffs_FFs_fs_S_S_S_Ffs_Fs_FFffs_S_s_S_SS_FS_FFSss_Fs_S_fs_s_S_FS_ffs_FffffFffffffs_S_fs_ffs_s_FS_s_S_Fsfs_S_s_FS_Fs_fS_FFs_fs_S_s_S_S_FS_FfFfs_S_S_S
jey16	_s_S_s_Sss_sssssss__Ssssssssss_s_s_fs_s_fsssssssfsssss_ssssss_SSss_sfssss_S_s_Sss_ssss_Ss_Ffssss_F_Ssssssssssssssssss_ssssss_ssssss_s_sss_ssss_s_sss_ssfsssssss_FFfsss_sss_s_sfssss_fsssssss_s_F_Ssssssss_sssss_SSssSS_F_s_Ss_s_F_s_s_Fsfss_s_S_Sss
jdh98	_FFFSfSS_S_Ffffssf_Sss_Sss_S_F_S_Sssssssssssss_Sss_FffSsssfsss_S_Ss_FSFSFSFSSs_S_s_s_Sss_Fssss_FSSsss_FFfSsssss_SSs_Ssf_Sss_FSss_Ss_fsss_FSSssS_Fsss_Ssss__SFFSS_ssss_Sssss_Ff_S_SSsfS_Ss_FSFFSfSFSSfFFFFsssss_ssssss_Ssss_Sfss_FFSssss_fssfsss_FSssss_f_SsSS_S
atr16	_S_S_S_ss_Fffs_Fs_fs_FS_fs_S_Fs_S_Fs_Fs_S_F_FFS_Fs_Fs_ss_Fs_s_s_SS_s_S_F_Fffs_s_ffs_S_ff__S_Ss_FFffs_Ffs_s_s_fs_fs_Fs_FFfs_s_s_S_fFss_Fffs_ffs_s_s_fs_ffs_fs_Sfs_Fs_S_Fs_FS_Fs_S_S_S_S_FFs_S_fs
pjs52	_fsss_FSs_ss_fsfss_ssss_fsss_Fsss_Sss_Fffsss_fffssfsss_Sss_Fsss_Sss_F_sss_SS_SSsS_Sss_Ss_Ss_Sss_SSS_Sfssss_FF_FFS_Ssss_SSfF__Ssss_fF_f_ffssss_Sss_Ss_Ssss
egm18	_S_s_S_fs_FFFs_FFFffsS_S_Ffs_Fs_s_FfffffS_Fffs_FS_fs_Fs_Fs_S_S_s_fs_s_s_S_s_s_s_fs_s_fs_S_Ffffs_S_Fffs_s_s_s_f_s_fffFfs_fffffffs_Ss_Fs
jhg10	_F_ffs_s_S_Fs_F_s_S_Ss_FS_fs_S_ffs_S__S_fs_s_S_s_Ffs_S_s_Fs_ffffs_S_S_FS_S_ffs_F_FSs_s_S_s_S_s_S_fs_S_S_S_s_S_Fs_s_ffs_s_S_ffs
jdh73	_s_S_s_sss_FS_s_fsf_S_s_s_Sss_Fsfs_S_S_FS_s_Ffs_FS_s_ff_FFs_s_s_S_s_sss_S_FFSs_S_FfSs_Fs_S_S_S_S_Sf_s_s__S_s_s_sf_ff_fssfss_s_s_S
leg33	_fss_ffssFffFssss_FF_S_sss_Fsffffss_sss_Ffsss_SSS_FSSS_S_SS_Ss_Ss_FSSs_Fsfss_ss_s_FFfSsfSs_Sfs_FFS_Sss_ss_S_FsFss_Sssss_ffsf_fSf_FSsss_Ss_Fss_f_Sss_Fs_s_Fs
kmh117	_FS_s_s_S_FfFfF_S_S_S_s_S_Fs_Ffffs_Fss_Fss_FS_s_fffffssfss_s_fffffss_fs_S_FFss_s_s_S_s_S_SS_FS_s_FSs_S_s_fsf_S_fs_Sfs_s_F_ffs_S_S_FFfFsS_F_fss_fffff_F_fffssffsfs_S_S
yaz44	_s_S_s_s_ss_S_ss_s_Fs_F_f_F_sfffs_s_s_s_FS_fs_fs_S_FS_ss_s_S_s_s_S_s__F_S_Fs_s_fs_S_S_S_S_fFfs_S_s_FS_s_FFS_f_S_Ffs_fs_f_s_S_S_S_S_S_s
bjs49	_ffss_Sss_fsss_fsss_FFFSSSS_Fss_FSs_FsS_Ss_Ss_sfss_Ss_Ss_fssssss_Sss_Ss_Ss_S_s_SsssSs_Ss_Sfs_ss_ss_FfFSSS_Ss_fss_sss_fss_Fsss_ffssssss_Ffsss_s_SsFF_FSSss_Ss_Sss_fssss_FSFSS_Ss_Ss_ffssssss_sssssss_ss_FSf_sfss_ssssssss
chg57	_S_fffffssfssss_f_sss_Fss_s_F_fs_FFs_S_Ss_S_s_S_Ss_s_s_S_sf_Ss_f_FSS_fsfss_ss_fs_fs_Fss_S_fs_fs_s_s_Ss_sf_S_fs_fs_fsfffss_Ss_s_ffs_FFFFFSf_Fs_s_Fs_fss_Ss_s_S_Ss_S_S_ss_Fs_fs_s_Ss_ss_f_F_FFff_Ffsfs_S_s_fss
jky3	_fs_F_S_s_Fs_s_fffs_Fs_fs_FSS_S_S_s_s_Fs_s_Fs_s_sfs_S_fs_FfS_F_s_S_s_fs_S_fS_SS_S_Fs_ffsS_fs_S_ssss_S_Ffsss_Fs_s_s_S_ffsff_Fs_S_s_Fs_fsss_s_s_S_S_F_S_fs_S_FsS_Fffs_S_s_S_S_S_Fss_FFFF
abr26	_F_s_S_S_FssS_FS_F_S_S_FF_s_S_s_fFFf_S_S_S_FS_S_s_FS_fs_fs_F_s_F_fs_Fs_S_fs_FFs_Fss_Fs_s_Ff_s
mjs187	_Ffssss_Fs_s_S_Fs_s_FS_fsfsssSSs_s_s_s_Fss_s_s_s_S_S_S_S_S_Sssssssss_s_S_S_S_FF__S_s_s_s_fsss_s_Fs_S_s_s_s_fs_s_s_S_s_Ff_s_S_S_s_s_f_S
ang92	_s_S_s_f_S_FS_s_S_S_S_S_S_SS_s_F_S_Fs_S_s_S_s_S_F_S_S_s_S_S_S_Ss_S_S_S_S_F_s_f_FS_f
kmt51	_FFSSSS_s_S_S_Fsss_S_SFSsS_fsss_S_fs_S_s_FS_S_S__Fs_S_s_S_FS_fff_Ff_fSffSf_S_Fss_FS_S_S_ffffs_S_S_FS_F_S_FFs_s_s_Fs_S_s_Ffs_s_Ss_S_s_Fs_S_ffs_Ffsss
sbb28	_Fsfss_sssss_SSfSSss_fsss_fss_ssssss_Sf_ffsfffsssss_FFssfSss_Sss_sFsss_Fffsssss_FSsss_FFF_SffSs__FSssss_SSs_FFSsss_ssfssss_Ssss_F_FSssfsss_FFFF_ssssss_FSSSSSS_FSsfsss_Fsss_ssss_ss_Fssss_Ss_Fsss_FfSsss_FFFSS_Sss_FF_Sss_fff_Ffffss_FFSsfs_SSS_Ss_FFffsSs_sss_fFFF_Sss_fssfsssss_sss_fss_FSsSs_FF_FfFSssssSs_F_sss_sss_sssss_ffsssss_F_Fff
sab155	_Fsssss_S_FFfffsssssss_S_SFffSfs_Ss_Fs_SS_fs_FSs_Fsss_s_ffffssfSsfFffSs_ffss_Fs_fsss_FffFfSss_f_Fssssss_sssss_s_fss_FfSSssfFSsS_S_ss_s_Sss_S_FffffFfSs_ffs_Fss_fssffssss_S_sFFssss_Sss_fs_sssfSfSssfsssss_FFFSsssfss_S_SffSfFFFSSSS_fSfF_FSs_FFfSsSFSsssSsSsS_ffss_s_Sss_S_FSss_Ss_S_fs_F_s_s
rsb45	_s_s_S_S_S_Fs_ffffF_fs_S_S_Ffs_S_S_fs_S_S_S_S_fs_s_Fs_fs_FFFS_S_fs_S_fs_FS_S_fs_FfFS_S_fs_S_s_fs_S_s_Ff_s_s_S_S
drr38	_s_s_F_F_S_FFFS_S_s_F_s_s_f_F_S_s_ff_s_F_f_S_FS_F_FFss_F_f_f_F__F_ffs_S_F_s_f_F_F_S_S
