skw17	_SSSfSsFsFfSFsSssFsSSSsSSsSSSsSFSFffssFFsFS_f_SsSFSFsFsSS_
teh26	_SSSSSSSSS_eeFss_SsSS_
jdh99	_FsSsSsFFfss_sssFFSSfFFSSfSfffsssfSsFSFFssSSfsFFFSSSfSFSsFSFffsssFFssfSSfSFFFfSFFFSfSFfFFSssFFSssSSFfSFSsSSsSsSFsSFSSSFsSFSfssFfSsSFsFSF_FFfffFffffSFsssSSFfsFFsSsFfsfFSSFsSssFsFFSsfSSFffFFSFFffsSsFSFSFSFFSFf_
dkd15	_EEeSSSSSe_eSSSSFsSSFSFfSSSFfSSFFffFsS_
clk93	_SsSSSS_EeESsSsSsFsssSFFsssSS_Ee_eee_SssSsSsFSssssSsse_FssFSSsFfsssssFFSSsssSsSSsSsSFsssSSssFfSsSssSsSSfsssSsSfssS_SsSSsSsSFFfFFsssSsssSsssssSFFSsSfSFSfSSSSSSSFSFsssSSF_FFSsSsFSssSS_FfSFssssSsFssSsssFssS_EEEEEEeeEEEEEEEeEEEeeEEEEeEEEESSfssSsFFSsssSFSFs_SSSsSssSssSssSSSssSsSssSfSsS_FF_EEEEeEeEeEEe_FssFFSF_SsseeEeEeeSFfssSsSSsSFSFSSSsFs_SSFSsSFssFssSSFfFSsfsssSSSfSFssSsFFFSSSssSFFsSFsSSSFFFfSFFFSsSSFfSSSfsSFFSss_SsF_f_fFsSFSSsFFfFSSSFFSFS_FFsFffsSSfsfSSFFSsSSSSFssSF_fSFSF_ffsssFfFSfFsSSfFsfsFSf_eeeeEEEEeEeEE_
jhb32	_FsssssssssFSSFSfFfs_FSssSssssssssssSssseFsfsF_EEe_EEFSsSFSSssFFSsssSEeF_eSsSSFsFsSsFsSSFsSsSFFffsFFFfssF_eeeFFsfssFfsFsFsSsSFffseee_EeeFFsfsSSSsFSsSsFsfSeeeeeeFSssSSSssSsfFSsfSFssseeeeFFssSSSSSFSfFSfSFFSSsSeeeSfsFSFSFFSsfFSSsFFfssFsseFFfSsfSfsSSsSfSSFFsfFff_eSSsFeeeeeefFFSFFfFSfFffSsfsfFSFssFFfsfFFeeFfsssFssFFFSsFFFfssFfffffSFSf_EeeeeFssFfSssFfFsFFFSFSsssFFSFSsSsEeSsfSfFFfSFfFfFeeFsFFSSfEESSFFFSFFFEEeFfsfFFFSsF_
bpc20	_SSsSsS_FFFSseFsSsSsSsSFssSS_ee_SFSsSssSSSSSSsFSSSSSSSSSsSSsSFsFSSSSssSFFssSSSSSsSsSSsSFFsF_Ssssssffss_FSsssSssSs_SfsssssSsfSsSsssSsSSsSSSSFsssssSfsfsSsssSFssssFssssFFssSSsfSsSssSSssSssSFFffSssFFFfsSfffSssSssSSSssffsssSssssSSsssSsssFSsSsssssSssssSSsssSFFsFSsFSsFsSSsSFFSF_
wli1	_SsSSSSS_SSSFfS_SsssFffsSfssSffSSsSSSSSsssssssFsSFFffSSFsFFsssFFsFsSSSssFssSsFsSSFssSSFss_SSSFF_FfFF_FsSSFFfsfffsfFfsFfs_FsSFSFsFSSssssSSSSFS_
kbs29	_eEEee_eeEeSSSssSSSsSssSsSSsFSsssSSssSs_FSsssssSssSsFssssssS_SsSSsssssSssSSSS_S_SsSsSsSsSSeeeeeeeEEE_EFSSSs_EESsSfSsSSsSsSsSsEESSSSSsSfssFSs_EEEEFSsSSsSSsSSSSSEEeFSsSsSsFFFSSSSFsssSSsSEeEEFFSSSsSsSsSssFSFSsSsEEESsSssSssSFssFsssSS_ESSsFssFsFf_Eee_SSSSFffsESSFfsSSeSSSSEESFeEeEEEEE_
bjs49	_SseeeeeeeSsssssSsSsssssssFsssfsssfssssssffssssssssSsssssssssssssssssssSsssssssSsssssss_SssFsssSssSfSSSssSSFFsssSsssSsSfsSsSsSsSFSFssSSsSssSsFssSsSfsseeeeeeeeeee_SSSFssSSeeeeeeeFFfSSSsFS_EeeSsFSsSsFSsSFSsSsFffSssSsFFfssseeFssFssFssFssfffSssSFssssfsfssFsSssffeSsFSfFSfSSseEFsFSsFSSS_FfssSssSssssSssSssSssFFsssSsfsFssSeeeFSsssFSfsssSssSfseeee_FfsssSsssssffffssssssFfssssssffssssssSfssffFfSsFfFfFfff_
rwm27	_SSSFfSsFSSFSSSSSSSS_SSSSsSFsSsssSSSSSSSFSsSSsSSSFSSFSsSSfsSFsSSFSSSSSFSSSsFFSsFSSSFFsFFSFsS_SSSSSFfsSSFSfSSFsSSFFSsFffsFfsF_
kmt51	_SSSFSSeeEeFFs_eeee_eeEeeeFsSFfsssSSeSSSSFssseESSSSSFsssSSeESsSSSeEEEEeEFSsssSFfssSSFfeFsssSSFffssfssFSFsssFssSFSFFSSF_FssSSSSFssssEeEeEEE_efSffSfSSFSsSSeEeSFSSFsSEFfSsSFFsSssSsSsFsSEEFFSSf_SEEEFfssFssSSEe_SSFFffsSFFsESSSFSEEeeFsFFsSFEEFSFs_EeFsSSeeEEeeFfffsFsFSFSFFfFS_
ril13	_SSSFsSE_SSFFSSSFSSSffsFSFsSS_FFFFsSsSfsFFSFSssFsF_SSFSSFFFSFs_FsS_eSssfSSFssSSsSSsSsFSFsSsSSsSSSS_FfsFSSS_SFsSFsFsFSSFfSF_SSSSFsSSssFsFFSsFsSsFFSSFsSSSFsSFsFsFeeSFsFsS_FfFsfsSfsFsFffFsSsSSFFffse_ffFFSSFfffFsFFSSSFFsSFfSF_FsSFFFfFFSFff_FFfF_FSSFFsFFFSSSssS_FFSFSFFFFSFSFsFffFFFfFsFFfsFFFfFfFsFfFsFFFsSFsFFsFFfsFF_
kan63	_SS_EeeSFSSfSSSFSsSFsSSSsSSSSSSFsssSssSSSSsF_eeF_
snb39	_FfSSSSS_SsssssSsfFsssssfsssFSsssSssssFssssSssseee_eee_FfSssFfsSssSssfffffeFfFfSssSsFssssFFfSsssSssFfsseeffssSSssfSssseeSsssSsSsFssssFFssSsssFSsssssFfSsssssssFs_FSsff_FfssSssssSssssSssssssSsssFsssfssssssssFFsssFsse_FfsssSSsSFFfFfSsFeFsssssssSSssFF_SssssssssssSSfFfssssFffssssFffssss_SSSsSS_eeeeeeeeEeeEeeeeSssssssssSfssSssFsssSssssFSSFFfeSssSSFfSFSFFFfSSSFSSsssFSSfF_eeeeFffFfSssFfssSfFffffSfssFfffssss_eeeSSSsSSSSFfFfSsSSFSssSssFSssFsFsssFFFffsSsssFSS_SsfsSSSfssss_eeeeSSFfSSSsssssSSsSsssSssffsssFFfSssSssFfSfsssseeSsssssssSffssffeFSsssssSssssssSsssssSfffsfssssffSssssssssFSssssseeee_Ssssss_eF_SsSsSSSsSssFffFfFsfSsSffSFfssSffSsFffSsFfFFfssFf_E_ee_eeesssssSSeEeFsSsSsSSsssfeSssssssssffsssssSssEESffssssSffssssFfssssSsssssSsssssEeSssssssssSssEeEeSsssssssSssffsssssssssSssEEeFSssssSSsSsssSSeeeeeeESsssssssSffssssfsssEeeSsssssSssssss_ESssSsssssffssSFsFsssFeSssSssSSsFeeeFFFfFsFFssssSsFFSfsssfsssssSssfsssssssseeFfsssssSsssffsssfssFssfffsfsssSssfsssFssFssssSsssee_FffSSFSssssSSsssssSfsssFsFSssseeSsssssssFFFffSfffSssssssssffsssssss_SssfssfssSsssssssssfsssssssssSsssffffssffssssFsssssFssSsssFssffsffssssfSs_
jme42	_SSS_EeEeSSSFSsFsSFsSSSSSFSFsFsSSSSsSSSSSSSSSSFSSSFsssSFsssSsfSssSsSSSFsss_eSSsFF_eSSSSSSeSSSSFFSSSeeeSSSSSEESSFSSSESFSsSsSeESFSsFS_EEFSfSFSsSeeFFffsssSFSsSFFFSFSsfssFssSSFFssee_
jum48	_SSSSSSssssSSSFFSSFsFsSFfsSFSFsFSsfsSSSSFSSSFSssFFffssFfFFfSssSfFsFsSFFFSSFFeeEee_
kdd28	_ssSSSS_SSssssFssSsSsSSFSSSFSSSsSSFsSSSSSSFFee_SSsFSSSFSSSSSSSSSFSsF_SSSSFSS_SSSSSSSSSSFFSSfSsSSSFS_FSSFSSSFSSSF_
ams404	_fsSSSSe_SSSSSeeeFsfsFsSFSSSSSfffsfFfffffeesFSSSssFFsssSFfsSFsSsFFSeeFfeffssFSsSF_S_eeeeFfSSffssFsFFsSSFfsFfsSSsFsFseFSSFSSfSSFsFffffFFsFffsffffSFfFFFFFFffffffSSFS_SsSFssFfSsSSSSSfsFsSSsSSFsSFSSFsSfsSsSSsSSfSSFSFFSSFsSFSFSFsSFFsfSFFSFSFFfsSFFsSFSFsFfsFFffSSFFSFFS_
mjs187	_SSSFSSFSSFSSSSSSSSeeeeeeeSSssSSsSSsSSSSSeeeeeee_SFsSSSSeeeeeeeeeeeeeeSsSFSFSSSSSSFsSFsFfssssSFssssssssFFfssssSseee_EEeeFsFsSSFS_eeEeSFssSSSSFsssFSssFfFf_FfsfssssssSsssssssseeeeeeeeeeSSSSssssSSSSssssSSSSSFfFsSsSSSSsseeeeeeeeeeeeeeeee_eeee_e_
qim8	_EEEeSSSSFsFSsfSSsSsSsssFSSSSSSSSSSSFSSSSSFSSSSFsSSssfsSSSSSSSSSFFsSSSSSSS_sssSSssSFSsSsSSSSFsSSSSFsSsSssSSFsSSsSsFFSsfSsSSsSSSSSFssssSsSSSSsSsSsSSSS_SS_FSsfFSSsFSSSFSSFfsF_FfsSSSFsSSFSsFFFFSFFSFSsSSSFSFSS_FsFFSFSSSs_FFsFfFFSFFffsFSFSSSsSSFsSFS_SSFSSFssSFSsFFsFSFsSSSSFsSsSfFSFFFFSfsffsSsSFSfFSSS_
brs112	_SS_SsssSssSsssFSssSsseeeeFSsSsSsSsssSsSsSsSsSssSsssSSSsFFsSsSSSSsssSsSsSsFSssSfsSSsssSfsFSsSssSssSSsssSSSSssssFsSSFsssSSsssssSsssSsss_SSSsSsssSFsssFsSsFsssSSSSfSSsSsSfsSssFSssSssSSsSsSsSSSsSsssFSsSSsFssSssFSsssSfFSSsFssSSssSSsssFSsSSssFsss_FfFFfFfF_
skm37	_SSsFsfeFfsSsssfsSFsSSsSSSsSsffsSssS_SSSSSfFssFsSsSsFsSSssSSsSFFFFssSsFfSsSFSssSSSFsFFSsFFfSFSFSfSeEeeeeeeeEeeeeeeeeee_
drr38	_sssFSFSSFSFSSsFSSSsSFFSSSSSSfFFSFSFFFFSFFFSFSFSSFSSFFSSSFfFfFF_FfsFSFFsSFFFFFFFFFF_SFSSFfSFFFfSSSFFSFFS_
doc23	_SsSSsSsSe_S_FsS_SSSFSSsFfSFS_SSSsSSSSFFFfFFfSSsSFssS_FSFsFSFSSFFFSSFF_
jky3	_eeeeeeeSsssSFsSFssFsSeSSsSFffs_eeSSSSsFsEeSSSSSfSEeEeFsSSSs_eeFffssFsFffffsFsFFse_eSe_SSsSSFSFsSFfSSFSsSFsSsSSSsSSSSFsSsSSFSSsSSFfsssSSsFffsFsFffs_ee_EEeeFsFsSSFfse_eeESFsSFsFs_eFsFsFfFe_eSfFSSF_e_FsSFsesfssFsSe_fsSFFsFSssssFsssFssFfsffFFFFSsS_eeFsFfssFeeeFeeeSSS_E_eeeESSSEeeSFsSSEFsSsssFseSfF_E_EEee_EEEEeEeEEe_
sbb28	_SsSssSssSssSsseEeeSssSssSssSsSsseeeSssSssSsFsssSssse_FfFFFSs_fFFFSSsfssSSffSsFsSSsssSSSSSSfSSssFsssSsssssSsSsFSssfsssSSFFSfssSsfsssFSsSsSssFFSsfsFSfsssssFfsssssFFfFsfsSssssSsssFsssEeeEeeeeeee_FSsfsssssSssSsSSsssSssssfssssssSSssssEEeeeeeee_SssSsSSsssSFSSFssssEeeFSsssssSSssssFFSsFssFSssFssssssFFFFFFfeFsssFsssssFfSSFFfSSfssssFsssFffsssssssFsfFSfSsfeSssssF_FffFsffssssSsfssssFSsssssFSsfsssFffSssFfSfffssSssFeeEEEeeEe_FsfFFFF_eFF_FFSsfsssFfSsfssssFFffsSsSssssSsssSsssSSsFFf_FffsssFssfssFFfssssSFfSsssFSfsssSsssSSsSSsssFssseeFssFFSsssFSssFSssssSfSfssss_SsFf_FsssSSsSsFsssFSsfSsFsssffssfsssFsfssFeeSsssFFfSFSsFFffssFFfssFsffsssFFSFSEe_
rkh9	_ee_eeFFfFeSssFssFssSSSSfsSFsSFfssFsSsssFssSfSSSFfFfsSfssfsfSsFfsFsSssssFsSSSFsSffFssfSsFssSFfsfFF_
